地域コード,地域,年齢,総数／計(人),総数／男(人),総数／女(人),日本人／計(人),日本人／男(人),日本人／女(人),外国人／計(人),外国人／男(人),外国人／女(人)
13000,総数,総数,13911902,6830918,7080984,13264486,6507674,6756812,647416,323244,324172
13000,総数,0～4,466743,238893,227850,447987,229129,218858,18756,9764,8992
13000,総数,5～9,536709,274253,262456,517492,264360,253132,19217,9893,9324
13000,総数,10～14,537279,275600,261679,520502,266823,253679,16777,8777,8000
13000,総数,15～19,548794,280469,268325,521497,265726,255771,27297,14743,12554
13000,総数,20～24,793024,398817,394207,705958,351718,354240,87066,47099,39967
13000,総数,25～29,1007235,506544,500691,903059,451339,451720,104176,55205,48971
13000,総数,30～34,929343,470865,458478,841084,425212,415872,88259,45653,42606
13000,総数,35～39,947659,480925,466734,880336,446691,433645,67323,34234,33089
13000,総数,40～44,997498,507815,489683,941419,480595,460824,56079,27220,28859
13000,総数,45～49,1089225,552372,536853,1047585,532741,514844,41640,19631,22009
13000,総数,50～54,1154975,581512,573463,1118062,565363,552699,36913,16149,20764
13000,総数,55～59,986049,505462,480587,956698,493217,463481,29351,12245,17106
13000,総数,60～64,774113,393688,380425,752594,384791,367803,21519,8897,12622
13000,総数,65～69,642800,319031,323769,629043,313405,315638,13757,5626,8131
13000,総数,70～74,713865,340749,373116,705613,337115,368498,8252,3634,4618
13000,総数,75～79,661305,296063,365242,656213,293801,362412,5092,2262,2830
13000,総数,80～84,539583,218971,320612,536420,217701,318719,3163,1270,1893
13000,総数,85～89,355645,127226,228419,353878,126596,227282,1767,630,1137
13000,総数,90～94,173373,50487,122886,172635,50263,122372,738,224,514
13000,総数,95～99,49345,10241,39104,49118,10170,38948,227,71,156
13000,総数,100以上,7340,935,6405,7293,918,6375,47,17,30
13100,区部,総数,9643024,4728534,4914490,9100160,4456338,4643822,542864,272196,270668
13100,区部,0～4,327556,167561,159995,311888,159397,152491,15668,8164,7504
13100,区部,5～9,363445,185320,178125,347227,176976,170251,16218,8344,7874
13100,区部,10～14,354970,181806,173164,340652,174303,166349,14318,7503,6815
13100,区部,15～19,355303,181520,173783,331808,168774,163034,23495,12746,10749
13100,区部,20～24,555563,277791,277772,483400,238613,244787,72163,39178,32985
13100,区部,25～29,773595,387304,386291,685425,340978,344447,88170,46326,41844
13100,区部,30～34,704002,355393,348609,628468,316690,311778,75534,38703,36831
13100,区部,35～39,694647,351267,343380,637384,322200,315184,57263,29067,28196
13100,区部,40～44,715676,363321,352355,668227,339956,328271,47449,23365,24084
13100,区部,45～49,766347,387494,378853,731746,370825,360921,34601,16669,17932
13100,区部,50～54,795396,398383,397013,765158,384717,380441,30238,13666,16572
13100,区部,55～59,671688,343655,328033,648147,333580,314567,23541,10075,13466
13100,区部,60～64,520085,264472,255613,502645,257187,245458,17440,7285,10155
13100,区部,65～69,424266,211102,213164,413041,206511,206530,11225,4591,6634
13100,区部,70～74,461948,221671,240277,455244,218740,236504,6704,2931,3773
13100,区部,75～79,427729,191766,235963,423658,189955,233703,4071,1811,2260
13100,区部,80～84,346497,138794,207703,343953,137777,206176,2544,1017,1527
13100,区部,85～89,232131,80510,151621,230727,80007,150720,1404,503,901
13100,区部,90～94,114203,32119,82084,113609,31939,81670,594,180,414
13100,区部,95～99,33023,6634,26389,32838,6578,26260,185,56,129
13100,区部,100以上,4954,651,4303,4915,635,4280,39,16,23
13101,千代田区,総数,68755,34412,34343,64897,32345,32552,3858,2067,1791
13101,千代田区,0～4,2825,1432,1393,2762,1392,1370,63,40,23
13101,千代田区,5～9,3329,1685,1644,3198,1623,1575,131,62,69
13101,千代田区,10～14,3042,1549,1493,2928,1484,1444,114,65,49
13101,千代田区,15～19,2482,1219,1263,2341,1149,1192,141,70,71
13101,千代田区,20～24,3366,1693,1673,2919,1449,1470,447,244,203
13101,千代田区,25～29,5675,3118,2557,5081,2782,2299,594,336,258
13101,千代田区,30～34,5544,2957,2587,5050,2686,2364,494,271,223
13101,千代田区,35～39,5819,3022,2797,5404,2810,2594,415,212,203
13101,千代田区,40～44,5888,3103,2785,5519,2910,2609,369,193,176
13101,千代田区,45～49,6117,3101,3016,5824,2945,2879,293,156,137
13101,千代田区,50～54,5526,2749,2777,5250,2610,2640,276,139,137
13101,千代田区,55～59,4414,2220,2194,4210,2113,2097,204,107,97
13101,千代田区,60～64,3269,1654,1615,3131,1579,1552,138,75,63
13101,千代田区,65～69,2476,1243,1233,2402,1206,1196,74,37,37
13101,千代田区,70～74,2475,1141,1334,2434,1116,1318,41,25,16
13101,千代田区,75～79,2430,1108,1322,2406,1093,1313,24,15,9
13101,千代田区,80～84,1792,757,1035,1773,750,1023,19,7,12
13101,千代田区,85～89,1281,407,874,1267,398,869,14,9,5
13101,千代田区,90～94,718,202,516,713,200,513,5,2,3
13101,千代田区,95～99,254,47,207,252,45,207,2,2,-
13101,千代田区,100以上,33,5,28,33,5,28,-,-,-
13102,中央区,総数,176835,84212,92623,166465,79054,87411,10370,5158,5212
13102,中央区,0～4,8460,4278,4182,8106,4102,4004,354,176,178
13102,中央区,5～9,8633,4405,4228,8239,4189,4050,394,216,178
13102,中央区,10～14,6838,3450,3388,6548,3291,3257,290,159,131
13102,中央区,15～19,4911,2477,2434,4652,2347,2305,259,130,129
13102,中央区,20～24,6635,3259,3376,6042,2962,3080,593,297,296
13102,中央区,25～29,12941,6401,6540,11794,5826,5968,1147,575,572
13102,中央区,30～34,15101,7279,7822,13558,6546,7012,1543,733,810
13102,中央区,35～39,15994,7490,8504,14515,6759,7756,1479,731,748
13102,中央区,40～44,16770,7972,8798,15547,7373,8174,1223,599,624
13102,中央区,45～49,17190,8144,9046,16277,7700,8577,913,444,469
13102,中央区,50～54,16164,7652,8512,15496,7309,8187,668,343,325
13102,中央区,55～59,12562,6201,6361,12062,5948,6114,500,253,247
13102,中央区,60～64,8752,4352,4400,8288,4118,4170,464,234,230
13102,中央区,65～69,5850,2871,2979,5600,2748,2852,250,123,127
13102,中央区,70～74,5776,2679,3097,5639,2603,3036,137,76,61
13102,中央区,75～79,5392,2315,3077,5325,2279,3046,67,36,31
13102,中央区,80～84,4162,1564,2598,4111,1544,2567,51,20,31
13102,中央区,85～89,2826,920,1906,2801,913,1888,25,7,18
13102,中央区,90～94,1418,417,1001,1407,413,994,11,4,7
13102,中央区,95～99,406,77,329,404,75,329,2,2,-
13102,中央区,100以上,54,9,45,54,9,45,-,-,-
13103,港区,総数,266306,125353,140953,245028,114470,130558,21278,10883,10395
13103,港区,0～4,12163,6228,5935,11366,5823,5543,797,405,392
13103,港区,5～9,13106,6616,6490,12135,6139,5996,971,477,494
13103,港区,10～14,10873,5483,5390,10115,5080,5035,758,403,355
13103,港区,15～19,8714,4457,4257,8099,4115,3984,615,342,273
13103,港区,20～24,11071,5353,5718,10064,4905,5159,1007,448,559
13103,港区,25～29,18247,9022,9225,16451,8130,8321,1796,892,904
13103,港区,30～34,20195,9528,10667,17746,8336,9410,2449,1192,1257
13103,港区,35～39,21794,10055,11739,19158,8775,10383,2636,1280,1356
13103,港区,40～44,23423,11022,12401,20772,9679,11093,2651,1343,1308
13103,港区,45～49,23898,11318,12580,21830,10239,11591,2068,1079,989
13103,港区,50～54,23618,11065,12553,21802,10036,11766,1816,1029,787
13103,港区,55～59,19696,9657,10039,18302,8853,9449,1394,804,590
13103,港区,60～64,14202,6895,7307,13231,6374,6857,971,521,450
13103,港区,65～69,10272,4929,5343,9711,4643,5068,561,286,275
13103,港区,70～74,10220,4525,5695,9864,4344,5520,356,181,175
13103,港区,75～79,9422,4047,5375,9217,3954,5263,205,93,112
13103,港区,80～84,7114,2712,4402,7000,2664,4336,114,48,66
13103,港区,85～89,4799,1587,3212,4718,1545,3173,81,42,39
13103,港区,90～94,2537,684,1853,2513,670,1843,24,14,10
13103,港区,95～99,799,154,645,793,150,643,6,4,2
13103,港区,100以上,143,16,127,141,16,125,2,-,2
13104,新宿区,総数,349226,175428,173798,305329,152484,152845,43897,22944,20953
13104,新宿区,0～4,9918,5077,4841,9136,4671,4465,782,406,376
13104,新宿区,5～9,10401,5269,5132,9516,4825,4691,885,444,441
13104,新宿区,10～14,9848,5017,4831,8924,4524,4400,924,493,431
13104,新宿区,15～19,11875,6183,5692,8622,4394,4228,3253,1789,1464
13104,新宿区,20～24,26921,13700,13221,17847,8731,9116,9074,4969,4105
13104,新宿区,25～29,35289,18393,16896,27691,14179,13512,7598,4214,3384
13104,新宿区,30～34,30021,16025,13996,24795,13271,11524,5226,2754,2472
13104,新宿区,35～39,27566,14676,12890,23897,12690,11207,3669,1986,1683
13104,新宿区,40～44,26855,14547,12308,23833,12963,10870,3022,1584,1438
13104,新宿区,45～49,26993,13999,12994,24493,12737,11756,2500,1262,1238
13104,新宿区,50～54,26910,13485,13425,24634,12380,12254,2276,1105,1171
13104,新宿区,55～59,22254,11353,10901,20635,10608,10027,1619,745,874
13104,新宿区,60～64,17522,8822,8700,16247,8297,7950,1275,525,750
13104,新宿区,65～69,14189,7066,7123,13321,6764,6557,868,302,566
13104,新宿区,70～74,14894,7288,7606,14471,7112,7359,423,176,247
13104,新宿区,75～79,14095,6369,7726,13837,6265,7572,258,104,154
13104,新宿区,80～84,10923,4365,6558,10784,4315,6469,139,50,89
13104,新宿区,85～89,7544,2577,4967,7474,2556,4918,70,21,49
13104,新宿区,90～94,3768,987,2781,3742,979,2763,26,8,18
13104,新宿区,95～99,1253,204,1049,1246,199,1047,7,5,2
13104,新宿区,100以上,187,26,161,184,24,160,3,2,1
13105,文京区,総数,232177,110561,121616,218141,103662,114479,14036,6899,7137
13105,文京区,0～4,9145,4682,4463,8889,4552,4337,256,130,126
13105,文京区,5～9,10740,5556,5184,10337,5343,4994,403,213,190
13105,文京区,10～14,9590,4863,4727,9202,4659,4543,388,204,184
13105,文京区,15～19,8687,4427,4260,8093,4093,4000,594,334,260
13105,文京区,20～24,13856,6973,6883,11313,5664,5649,2543,1309,1234
13105,文京区,25～29,18563,9264,9299,15528,7750,7778,3035,1514,1521
13105,文京区,30～34,17341,8611,8730,15475,7697,7778,1866,914,952
13105,文京区,35～39,17639,8472,9167,16368,7878,8490,1271,594,677
13105,文京区,40～44,18523,8966,9557,17452,8491,8961,1071,475,596
13105,文京区,45～49,18922,8974,9948,18221,8641,9580,701,333,368
13105,文京区,50～54,18160,8513,9647,17593,8243,9350,567,270,297
13105,文京区,55～59,15416,7251,8165,14945,7031,7914,471,220,251
13105,文京区,60～64,11893,5703,6190,11565,5545,6020,328,158,170
13105,文京区,65～69,9564,4614,4950,9326,4513,4813,238,101,137
13105,文京区,70～74,9734,4446,5288,9612,4382,5230,122,64,58
13105,文京区,75～79,8942,3933,5009,8861,3896,4965,81,37,44
13105,文京区,80～84,6945,2766,4179,6901,2750,4151,44,16,28
13105,文京区,85～89,4914,1626,3288,4885,1620,3265,29,6,23
13105,文京区,90～94,2656,741,1915,2635,734,1901,21,7,14
13105,文京区,95～99,823,161,662,818,161,657,5,-,5
13105,文京区,100以上,124,19,105,122,19,103,2,-,2
13106,台東区,総数,212388,108097,104291,193903,98687,95216,18485,9410,9075
13106,台東区,0～4,6043,3063,2980,5726,2902,2824,317,161,156
13106,台東区,5～9,5979,2983,2996,5664,2824,2840,315,159,156
13106,台東区,10～14,5641,2926,2715,5332,2753,2579,309,173,136
13106,台東区,15～19,5972,3099,2873,5129,2618,2511,843,481,362
13106,台東区,20～24,10823,5410,5413,8221,3984,4237,2602,1426,1176
13106,台東区,25～29,20667,10479,10188,17375,8758,8617,3292,1721,1571
13106,台東区,30～34,19109,10180,8929,16375,8767,7608,2734,1413,1321
13106,台東区,35～39,16857,9046,7811,15011,8083,6928,1846,963,883
13106,台東区,40～44,16477,8736,7741,14944,7982,6962,1533,754,779
13106,台東区,45～49,17269,9127,8142,16098,8550,7548,1171,577,594
13106,台東区,50～54,17585,9087,8498,16506,8591,7915,1079,496,583
13106,台東区,55～59,14216,7549,6667,13340,7147,6193,876,402,474
13106,台東区,60～64,10996,5902,5094,10345,5626,4719,651,276,375
13106,台東区,65～69,9072,4732,4340,8651,4543,4108,421,189,232
13106,台東区,70～74,10320,5389,4931,10109,5293,4816,211,96,115
13106,台東区,75～79,9547,4570,4977,9413,4501,4912,134,69,65
13106,台東区,80～84,7531,3132,4399,7452,3098,4354,79,34,45
13106,台東区,85～89,5081,1847,3234,5039,1835,3204,42,12,30
13106,台東区,90～94,2398,685,1713,2377,679,1698,21,6,15
13106,台東区,95～99,703,146,557,694,144,550,9,2,7
13106,台東区,100以上,102,9,93,102,9,93,-,-,-
13107,墨田区,総数,284555,140148,144407,268892,132882,136010,15663,7266,8397
13107,墨田区,0～4,9308,4759,4549,9003,4605,4398,305,154,151
13107,墨田区,5～9,9385,4752,4633,9049,4570,4479,336,182,154
13107,墨田区,10～14,8872,4597,4275,8524,4411,4113,348,186,162
13107,墨田区,15～19,9041,4631,4410,8419,4283,4136,622,348,274
13107,墨田区,20～24,15535,7675,7860,13379,6520,6859,2156,1155,1001
13107,墨田区,25～29,28300,13938,14362,25649,12614,13035,2651,1324,1327
13107,墨田区,30～34,25191,12659,12532,22869,11513,11356,2322,1146,1176
13107,墨田区,35～39,21726,11003,10723,20160,10267,9893,1566,736,830
13107,墨田区,40～44,21001,10723,10278,19710,10160,9550,1291,563,728
13107,墨田区,45～49,21869,11171,10698,20809,10743,10066,1060,428,632
13107,墨田区,50～54,22241,11358,10883,21276,11011,10265,965,347,618
13107,墨田区,55～59,18235,9407,8828,17460,9145,8315,775,262,513
13107,墨田区,60～64,14027,7193,6834,13458,7004,6454,569,189,380
13107,墨田区,65～69,12020,5952,6068,11747,5868,5879,273,84,189
13107,墨田区,70～74,14094,6934,7160,13889,6860,7029,205,74,131
13107,墨田区,75～79,12513,5732,6781,12404,5688,6716,109,44,65
13107,墨田区,80～84,10474,4179,6295,10407,4148,6259,67,31,36
13107,墨田区,85～89,6762,2453,4309,6736,2444,4292,26,9,17
13107,墨田区,90～94,3034,840,2194,3021,838,2183,13,2,11
13107,墨田区,95～99,818,173,645,815,172,643,3,1,2
13107,墨田区,100以上,109,19,90,108,18,90,1,1,-
13108,江東区,総数,539108,264566,274542,502102,246518,255584,37006,18048,18958
13108,江東区,0～4,20652,10472,10180,19122,9695,9427,1530,777,753
13108,江東区,5～9,22979,11741,11238,21254,10864,10390,1725,877,848
13108,江東区,10～14,22144,11364,10780,20683,10612,10071,1461,752,709
13108,江東区,15～19,20688,10603,10085,19376,9867,9509,1312,736,576
13108,江東区,20～24,26981,13678,13303,24040,12062,11978,2941,1616,1325
13108,江東区,25～29,38633,19350,19283,33809,16882,16927,4824,2468,2356
13108,江東区,30～34,36932,18416,18516,31757,15900,15857,5175,2516,2659
13108,江東区,35～39,39509,19670,19839,35015,17440,17575,4494,2230,2264
13108,江東区,40～44,41677,20992,20685,37752,19014,18738,3925,1978,1947
13108,江東区,45～49,45217,22747,22470,42569,21520,21049,2648,1227,1421
13108,江東区,50～54,47122,23816,23306,44899,22816,22083,2223,1000,1223
13108,江東区,55～59,37019,19209,17810,35374,18591,16783,1645,618,1027
13108,江東区,60～64,26798,13600,13198,25582,13113,12469,1216,487,729
13108,江東区,65～69,23179,11190,11989,22382,10858,11524,797,332,465
13108,江東区,70～74,27118,12812,14306,26648,12617,14031,470,195,275
13108,江東区,75～79,24481,11054,13427,24211,10937,13274,270,117,153
13108,江東区,80～84,19699,8011,11688,19518,7943,11575,181,68,113
13108,江東区,85～89,11824,4189,7635,11714,4147,7567,110,42,68
13108,江東区,90～94,5007,1394,3613,4958,1385,3573,49,9,40
13108,江東区,95～99,1255,242,1013,1245,239,1006,10,3,7
13108,江東区,100以上,194,16,178,194,16,178,-,-,-
13109,品川区,総数,408280,199866,208414,392795,192060,200735,15485,7806,7679
13109,品川区,0～4,15784,8040,7744,15382,7826,7556,402,214,188
13109,品川区,5～9,16657,8492,8165,16253,8287,7966,404,205,199
13109,品川区,10～14,14746,7529,7217,14388,7334,7054,358,195,163
13109,品川区,15～19,13127,6682,6445,12710,6478,6232,417,204,213
13109,品川区,20～24,20150,10084,10066,18733,9296,9437,1417,788,629
13109,品川区,25～29,34150,17324,16826,31772,16089,15683,2378,1235,1143
13109,品川区,30～34,31855,16006,15849,29620,14854,14766,2235,1152,1083
13109,品川区,35～39,33394,16828,16566,31543,15888,15655,1851,940,911
13109,品川区,40～44,33216,16835,16381,31566,15945,15621,1650,890,760
13109,品川区,45～49,33687,16943,16744,32608,16399,16209,1079,544,535
13109,品川区,50～54,33394,16530,16864,32357,16071,16286,1037,459,578
13109,品川区,55～59,27024,13806,13218,26260,13441,12819,764,365,399
13109,品川区,60～64,20107,10175,9932,19547,9936,9611,560,239,321
13109,品川区,65～69,16655,8105,8550,16287,7959,8328,368,146,222
13109,品川区,70～74,18626,8760,9866,18369,8642,9727,257,118,139
13109,品川区,75～79,17366,7917,9449,17209,7852,9357,157,65,92
13109,品川区,80～84,13463,5332,8131,13387,5304,8083,76,28,48
13109,品川区,85～89,8737,2955,5782,8690,2942,5748,47,13,34
13109,品川区,90～94,4507,1172,3335,4486,1168,3318,21,4,17
13109,品川区,95～99,1410,320,1090,1403,318,1085,7,2,5
13109,品川区,100以上,225,31,194,225,31,194,-,-,-
13110,目黒区,総数,279520,131816,147704,268972,126265,142707,10548,5551,4997
13110,目黒区,0～4,9622,4942,4680,9397,4814,4583,225,128,97
13110,目黒区,5～9,10609,5548,5061,10373,5434,4939,236,114,122
13110,目黒区,10～14,10317,5340,4977,10088,5228,4860,229,112,117
13110,目黒区,15～19,9331,4645,4686,9115,4545,4570,216,100,116
13110,目黒区,20～24,13972,6754,7218,13027,6266,6761,945,488,457
13110,目黒区,25～29,22684,11277,11407,21138,10482,10656,1546,795,751
13110,目黒区,30～34,21548,10446,11102,19902,9602,10300,1646,844,802
13110,目黒区,35～39,21408,10250,11158,20068,9540,10528,1340,710,630
13110,目黒区,40～44,22829,10816,12013,21795,10253,11542,1034,563,471
13110,目黒区,45～49,24011,11382,12629,23216,10920,12296,795,462,333
13110,目黒区,50～54,23173,10699,12474,22468,10309,12159,705,390,315
13110,目黒区,55～59,19728,9451,10277,19160,9128,10032,568,323,245
13110,目黒区,60～64,15057,7340,7717,14644,7109,7535,413,231,182
13110,目黒区,65～69,11575,5506,6069,11291,5372,5919,284,134,150
13110,目黒区,70～74,11851,5410,6441,11712,5348,6364,139,62,77
13110,目黒区,75～79,11589,5029,6560,11484,4979,6505,105,50,55
13110,目黒区,80～84,9070,3601,5469,9008,3576,5432,62,25,37
13110,目黒区,85～89,6264,2107,4157,6233,2096,4137,31,11,20
13110,目黒区,90～94,3535,1015,2520,3517,1011,2506,18,4,14
13110,目黒区,95～99,1183,234,949,1175,231,944,8,3,5
13110,目黒区,100以上,164,24,140,161,22,139,3,2,1
13111,大田区,総数,733634,364637,368997,705237,350715,354522,28397,13922,14475
13111,大田区,0～4,23364,12027,11337,22521,11584,10937,843,443,400
13111,大田区,5～9,26021,13381,12640,25229,12955,12274,792,426,366
13111,大田区,10～14,26087,13349,12738,25383,12974,12409,704,375,329
13111,大田区,15～19,26591,13412,13179,25794,12999,12795,797,413,384
13111,大田区,20～24,44489,22427,22062,41700,20908,20792,2789,1519,1270
13111,大田区,25～29,62542,31430,31112,57457,28718,28739,5085,2712,2373
13111,大田区,30～34,51022,26393,24629,46769,24110,22659,4253,2283,1970
13111,大田区,35～39,49429,25519,23910,46465,24029,22436,2964,1490,1474
13111,大田区,40～44,50703,26001,24702,48246,24893,23353,2457,1108,1349
13111,大田区,45～49,55996,28856,27140,54104,27994,26110,1892,862,1030
13111,大田区,50～54,61201,31301,29900,59391,30584,28807,1810,717,1093
13111,大田区,55～59,51660,27187,24473,50218,26654,23564,1442,533,909
13111,大田区,60～64,40157,20847,19310,39211,20474,18737,946,373,573
13111,大田区,65～69,33760,17069,16691,33124,16809,16315,636,260,376
13111,大田区,70～74,38011,18599,19412,37589,18431,19158,422,168,254
13111,大田区,75～79,35357,16148,19209,35098,16028,19070,259,120,139
13111,大田区,80～84,27882,11625,16257,27727,11570,16157,155,55,100
13111,大田区,85～89,17668,6182,11486,17570,6134,11436,98,48,50
13111,大田区,90～94,8669,2346,6323,8626,2334,6292,43,12,31
13111,大田区,95～99,2643,490,2153,2636,486,2150,7,4,3
13111,大田区,100以上,382,48,334,379,47,332,3,1,2
13112,世田谷区,総数,918141,434591,483550,892604,421347,471257,25537,13244,12293
13112,世田谷区,0～4,30775,15790,14985,30241,15540,14701,534,250,284
13112,世田谷区,5～9,36720,18694,18026,36138,18395,17743,582,299,283
13112,世田谷区,10～14,37441,19142,18299,36930,18864,18066,511,278,233
13112,世田谷区,15～19,36618,18934,17684,35643,18436,17207,975,498,477
13112,世田谷区,20～24,51548,25632,25916,48440,23982,24458,3108,1650,1458
13112,世田谷区,25～29,66842,31947,34895,62915,29903,33012,3927,2044,1883
13112,世田谷区,30～34,60943,29010,31933,57188,27118,30070,3755,1892,1863
13112,世田谷区,35～39,62734,29632,33102,59782,28099,31683,2952,1533,1419
13112,世田谷区,40～44,69569,33222,36347,67137,31946,35191,2432,1276,1156
13112,世田谷区,45～49,77148,36761,40387,75342,35793,39549,1806,968,838
13112,世田谷区,50～54,77524,36433,41091,76081,35668,40413,1443,765,678
13112,世田谷区,55～59,68673,33950,34723,67492,33300,34192,1181,650,531
13112,世田谷区,60～64,53439,26238,27201,52553,25773,26780,886,465,421
13112,世田谷区,65～69,41030,19903,21127,40459,19617,20842,571,286,285
13112,世田谷区,70～74,40976,18915,22061,40635,18756,21879,341,159,182
13112,世田谷区,75～79,38501,16851,21650,38277,16750,21527,224,101,123
13112,世田谷区,80～84,30045,11843,18202,29883,11765,18118,162,78,84
13112,世田谷区,85～89,21533,7549,13984,21454,7517,13937,79,32,47
13112,世田谷区,90～94,11742,3306,8436,11692,3292,8400,50,14,36
13112,世田谷区,95～99,3719,746,2973,3706,744,2962,13,2,11
13112,世田谷区,100以上,621,93,528,616,89,527,5,4,1
13113,渋谷区,総数,230609,110568,120041,218674,104063,114611,11935,6505,5430
13113,渋谷区,0～4,7876,3954,3922,7653,3837,3816,223,117,106
13113,渋谷区,5～9,8366,4148,4218,8063,4020,4043,303,128,175
13113,渋谷区,10～14,7430,3749,3681,7154,3603,3551,276,146,130
13113,渋谷区,15～19,6670,3304,3366,6328,3123,3205,342,181,161
13113,渋谷区,20～24,10739,5149,5590,9614,4571,5043,1125,578,547
13113,渋谷区,25～29,18974,9586,9388,17323,8747,8576,1651,839,812
13113,渋谷区,30～34,19207,9734,9473,17433,8754,8679,1774,980,794
13113,渋谷区,35～39,19600,9724,9876,18061,8871,9190,1539,853,686
13113,渋谷区,40～44,20409,10326,10083,19221,9632,9589,1188,694,494
13113,渋谷区,45～49,20522,10054,10468,19556,9465,10091,966,589,377
13113,渋谷区,50～54,19158,8974,10184,18322,8486,9836,836,488,348
13113,渋谷区,55～59,16229,7983,8246,15635,7644,7991,594,339,255
13113,渋谷区,60～64,12308,5996,6312,11867,5754,6113,441,242,199
13113,渋谷区,65～69,9318,4443,4875,9033,4305,4728,285,138,147
13113,渋谷区,70～74,9373,4399,4974,9226,4324,4902,147,75,72
13113,渋谷区,75～79,8929,3846,5083,8813,3780,5033,116,66,50
13113,渋谷区,80～84,6811,2672,4139,6744,2642,4102,67,30,37
13113,渋谷区,85～89,4883,1605,3278,4854,1590,3264,29,15,14
13113,渋谷区,90～94,2763,729,2034,2740,725,2015,23,4,19
13113,渋谷区,95～99,888,170,718,881,167,714,7,3,4
13113,渋谷区,100以上,156,23,133,153,23,130,3,-,3
13114,中野区,総数,337377,170371,167006,316164,159205,156959,21213,11166,10047
13114,中野区,0～4,10239,5285,4954,9751,5023,4728,488,262,226
13114,中野区,5～9,10395,5307,5088,10054,5116,4938,341,191,150
13114,中野区,10～14,9563,4872,4691,9265,4723,4542,298,149,149
13114,中野区,15～19,10229,5244,4985,8943,4517,4426,1286,727,559
13114,中野区,20～24,21928,11107,10821,17578,8786,8792,4350,2321,2029
13114,中野区,25～29,33040,16986,16054,28745,14670,14075,4295,2316,1979
13114,中野区,30～34,29821,15935,13886,26664,14239,12425,3157,1696,1461
13114,中野区,35～39,27612,14953,12659,25575,13859,11716,2037,1094,943
13114,中野区,40～44,26437,14317,12120,25004,13560,11444,1433,757,676
13114,中野区,45～49,26414,14254,12160,25479,13785,11694,935,469,466
13114,中野区,50～54,25749,13421,12328,24952,13017,11935,797,404,393
13114,中野区,55～59,21818,11471,10347,21138,11164,9974,680,307,373
13114,中野区,60～64,17158,8700,8458,16705,8514,8191,453,186,267
13114,中野区,65～69,13854,6849,7005,13573,6728,6845,281,121,160
13114,中野区,70～74,15046,7145,7901,14880,7070,7810,166,75,91
13114,中野区,75～79,13696,6135,7561,13594,6084,7510,102,51,51
13114,中野区,80～84,10890,4303,6587,10835,4284,6551,55,19,36
13114,中野区,85～89,7740,2613,5127,7704,2600,5104,36,13,23
13114,中野区,90～94,4248,1186,3062,4233,1180,3053,15,6,9
13114,中野区,95～99,1309,262,1047,1303,260,1043,6,2,4
13114,中野区,100以上,191,26,165,189,26,163,2,-,2
13115,杉並区,総数,572843,275440,297403,553665,265669,287996,19178,9771,9407
13115,杉並区,0～4,19098,9686,9412,18712,9483,9229,386,203,183
13115,杉並区,5～9,20770,10574,10196,20407,10383,10024,363,191,172
13115,杉並区,10～14,19884,10213,9671,19559,10037,9522,325,176,149
13115,杉並区,15～19,19948,10114,9834,19053,9634,9419,895,480,415
13115,杉並区,20～24,33399,16305,17094,30027,14576,15451,3372,1729,1643
13115,杉並区,25～29,48237,23429,24808,44470,21510,22960,3767,1919,1848
13115,杉並区,30～34,42553,20927,21626,39672,19495,20177,2881,1432,1449
13115,杉並区,35～39,42546,21316,21230,40517,20273,20244,2029,1043,986
13115,杉並区,40～44,43419,21762,21657,41979,20999,20980,1440,763,677
13115,杉並区,45～49,45361,22383,22978,44371,21840,22531,990,543,447
13115,杉並区,50～54,45825,22314,23511,45048,21928,23120,777,386,391
13115,杉並区,55～59,39746,19907,19839,39139,19609,19530,607,298,309
13115,杉並区,60～64,31622,15649,15973,31132,15427,15705,490,222,268
13115,杉並区,65～69,25811,12605,13206,25470,12446,13024,341,159,182
13115,杉並区,70～74,26199,12179,14020,25983,12081,13902,216,98,118
13115,杉並区,75～79,24680,10960,13720,24539,10889,13650,141,71,70
13115,杉並区,80～84,19353,7712,11641,19280,7683,11597,73,29,44
13115,杉並区,85～89,13689,4652,9037,13640,4635,9005,49,17,32
13115,杉並区,90～94,7758,2214,5544,7734,2205,5529,24,9,15
13115,杉並区,95～99,2553,496,2057,2543,493,2050,10,3,7
13115,杉並区,100以上,392,43,349,390,43,347,2,-,2
13116,豊島区　,総数,291650,146383,145267,258918,129425,129493,32732,16958,15774
13116,豊島区　,0～4,8754,4475,4279,8104,4138,3966,650,337,313
13116,豊島区　,5～9,8921,4548,4373,8439,4286,4153,482,262,220
13116,豊島区　,10～14,8420,4243,4177,8014,4025,3989,406,218,188
13116,豊島区　,15～19,9523,4844,4679,7747,3882,3865,1776,962,814
13116,豊島区　,20～24,21306,10936,10370,13814,6772,7042,7492,4164,3328
13116,豊島区　,25～29,29561,15097,14464,22000,11100,10900,7561,3997,3564
13116,豊島区　,30～34,25590,13296,12294,20717,10788,9929,4873,2508,2365
13116,豊島区　,35～39,23208,12233,10975,20443,10807,9636,2765,1426,1339
13116,豊島区　,40～44,22238,11973,10265,20413,11076,9337,1825,897,928
13116,豊島区　,45～49,22544,11860,10684,21229,11244,9985,1315,616,699
13116,豊島区　,50～54,22165,11407,10758,21031,10878,10153,1134,529,605
13116,豊島区　,55～59,18406,9572,8834,17564,9191,8373,842,381,461
13116,豊島区　,60～64,14406,7469,6937,13728,7185,6543,678,284,394
13116,豊島区　,65～69,12240,6127,6113,11803,5955,5848,437,172,265
13116,豊島区　,70～74,12942,6379,6563,12691,6264,6427,251,115,136
13116,豊島区　,75～79,11800,5285,6515,11696,5236,6460,104,49,55
13116,豊島区　,80～84,9099,3637,5462,9027,3608,5419,72,29,43
13116,豊島区　,85～89,6105,1940,4165,6064,1933,4131,41,7,34
13116,豊島区　,90～94,3285,876,2409,3269,873,2396,16,3,13
13116,豊島区　,95～99,967,162,805,956,160,796,11,2,9
13116,豊島区　,100以上,170,24,146,169,24,145,1,-,1
13117,北区,総数,357701,177688,180013,330339,163827,166512,27362,13861,13501
13117,北区,0～4,12127,6194,5933,11228,5718,5510,899,476,423
13117,北区,5～9,12947,6572,6375,12134,6160,5974,813,412,401
13117,北区,10～14,11742,6105,5637,11111,5769,5342,631,336,295
13117,北区,15～19,11957,6067,5890,10679,5351,5328,1278,716,562
13117,北区,20～24,20988,10654,10334,16550,8228,8322,4438,2426,2012
13117,北区,25～29,30349,15538,14811,25269,12878,12391,5080,2660,2420
13117,北区,30～34,27325,14162,13163,23302,12084,11218,4023,2078,1945
13117,北区,35～39,26404,13778,12626,23645,12366,11279,2759,1412,1347
13117,北区,40～44,25623,13528,12095,23436,12450,10986,2187,1078,1109
13117,北区,45～49,26741,14094,12647,25313,13386,11927,1428,708,720
13117,北区,50～54,26889,14001,12888,25731,13490,12241,1158,511,647
13117,北区,55～59,21959,11412,10547,21027,11041,9986,932,371,561
13117,北区,60～64,17877,9129,8748,17191,8883,8308,686,246,440
13117,北区,65～69,16168,8125,8043,15723,7959,7764,445,166,279
13117,北区,70～74,19346,9467,9879,19078,9351,9727,268,116,152
13117,北区,75～79,18040,8010,10030,17875,7939,9936,165,71,94
13117,北区,80～84,14862,5942,8920,14766,5899,8867,96,43,53
13117,北区,85～89,9863,3259,6604,9813,3235,6578,50,24,26
13117,北区,90～94,4913,1347,3566,4891,1337,3554,22,10,12
13117,北区,95～99,1379,282,1097,1376,281,1095,3,1,2
13117,北区,100以上,202,22,180,201,22,179,1,-,1
13118,荒川区,総数,219268,108991,110277,198017,98488,99529,21251,10503,10748
13118,荒川区,0～4,7616,3932,3684,7020,3607,3413,596,325,271
13118,荒川区,5～9,8073,4108,3965,7524,3824,3700,549,284,265
13118,荒川区,10～14,8080,4135,3945,7527,3836,3691,553,299,254
13118,荒川区,15～19,8506,4349,4157,7444,3791,3653,1062,558,504
13118,荒川区,20～24,12896,6631,6265,9839,4922,4917,3057,1709,1348
13118,荒川区,25～29,17058,8714,8344,13914,7063,6851,3144,1651,1493
13118,荒川区,30～34,16133,8240,7893,13457,6877,6580,2676,1363,1313
13118,荒川区,35～39,15491,7969,7522,13414,6931,6483,2077,1038,1039
13118,荒川区,40～44,15836,8123,7713,14222,7355,6867,1614,768,846
13118,荒川区,45～49,17202,8870,8332,15918,8285,7633,1284,585,699
13118,荒川区,50～54,17411,8890,8521,16199,8366,7833,1212,524,688
13118,荒川区,55～59,14323,7374,6949,13270,6914,6356,1053,460,593
13118,荒川区,60～64,11514,5945,5569,10717,5617,5100,797,328,469
13118,荒川区,65～69,10039,5019,5020,9456,4788,4668,583,231,352
13118,荒川区,70～74,11623,5741,5882,11253,5592,5661,370,149,221
13118,荒川区,75～79,10282,4820,5462,10008,4715,5293,274,105,169
13118,荒川区,80～84,8395,3388,5007,8209,3304,4905,186,84,102
13118,荒川区,85～89,5488,1915,3573,5385,1886,3499,103,29,74
13118,荒川区,90～94,2525,683,1842,2488,673,1815,37,10,27
13118,荒川区,95～99,670,131,539,649,128,521,21,3,18
13118,荒川区,100以上,107,14,93,104,14,90,3,-,3
13119,板橋区,総数,572927,280059,292868,540576,264374,276202,32351,15685,16666
13119,板橋区,0～4,17496,8868,8628,16511,8353,8158,985,515,470
13119,板橋区,5～9,20303,10409,9894,19433,9942,9491,870,467,403
13119,板橋区,10～14,20403,10556,9847,19665,10188,9477,738,368,370
13119,板橋区,15～19,21412,10936,10476,20041,10205,9836,1371,731,640
13119,板橋区,20～24,36499,17607,18892,31516,14944,16572,4983,2663,2320
13119,板橋区,25～29,47329,22733,24596,41302,19656,21646,6027,3077,2950
13119,板橋区,30～34,40894,20202,20692,36198,17844,18354,4696,2358,2338
13119,板橋区,35～39,38723,19713,19010,35620,18166,17454,3103,1547,1556
13119,板橋区,40～44,40321,20539,19782,37708,19334,18374,2613,1205,1408
13119,板橋区,45～49,43408,22388,21020,41648,21623,20025,1760,765,995
13119,板橋区,50～54,45348,23171,22177,43822,22565,21257,1526,606,920
13119,板橋区,55～59,37995,19751,18244,36736,19296,17440,1259,455,804
13119,板橋区,60～64,31087,15988,15099,30071,15589,14482,1016,399,617
13119,板橋区,65～69,26864,13405,13459,26214,13188,13026,650,217,433
13119,板橋区,70～74,30552,14926,15626,30203,14773,15430,349,153,196
13119,板橋区,75～79,27841,12512,15329,27643,12429,15214,198,83,115
13119,板橋区,80～84,22129,8977,13152,22010,8928,13082,119,49,70
13119,板橋区,85～89,14723,4954,9769,14666,4936,9730,57,18,39
13119,板橋区,90～94,7202,1987,5215,7175,1978,5197,27,9,18
13119,板橋区,95～99,2112,412,1700,2108,412,1696,4,-,4
13119,板橋区,100以上,286,25,261,286,25,261,-,-,-
13120,練馬区,総数,741540,358739,382801,718345,347707,370638,23195,11032,12163
13120,練馬区,0～4,26081,13409,12672,25499,13097,12402,582,312,270
13120,練馬区,5～9,29273,14937,14336,28620,14600,14020,653,337,316
13120,練馬区,10～14,29624,15178,14446,29002,14862,14140,622,316,306
13120,練馬区,15～19,30770,15823,14947,29819,15353,14466,951,470,481
13120,練馬区,20～24,43258,21139,22119,40093,19490,20603,3165,1649,1516
13120,練馬区,25～29,53174,25210,27964,49214,23267,25947,3960,1943,2017
13120,練馬区,30～34,50293,24240,26053,47207,22752,24455,3086,1488,1598
13120,練馬区,35～39,50708,25131,25577,48436,24055,24381,2272,1076,1196
13120,練馬区,40～44,51752,26063,25689,49787,25149,24638,1965,914,1051
13120,練馬区,45～49,55603,27995,27608,54118,27321,26797,1485,674,811
13120,練馬区,50～54,60500,30193,30307,59127,29566,29561,1373,627,746
13120,練馬区,55～59,53977,27419,26558,52927,27010,25917,1050,409,641
13120,練馬区,60～64,43373,21837,21536,42592,21526,21066,781,311,470
13120,練馬区,65～69,34431,17255,17176,33972,17068,16904,459,187,272
13120,練馬区,70～74,35415,16954,18461,35082,16805,18277,333,149,184
13120,練馬区,75～79,32242,14227,18015,32052,14141,17911,190,86,104
13120,練馬区,80～84,27679,10877,16802,27535,10831,16704,144,46,98
13120,練馬区,85～89,19770,7038,12732,19691,7018,12673,79,20,59
13120,練馬区,90～94,10233,3081,7152,10200,3069,7131,33,12,21
13120,練馬区,95～99,2963,672,2291,2954,668,2286,9,4,5
13120,練馬区,100以上,421,61,360,418,59,359,3,2,1
13121,足立区,総数,693223,346947,346276,653892,328006,325886,39331,18941,20390
13121,足立区,0～4,20962,10780,10182,19603,10065,9538,1359,715,644
13121,足立区,5～9,24629,12516,12113,23172,11777,11395,1457,739,718
13121,足立区,10～14,26909,13739,13170,25532,13037,12495,1377,702,675
13121,足立区,15～19,28184,14515,13669,26706,13686,13020,1478,829,649
13121,足立区,20～24,39882,20236,19646,36413,18210,18203,3469,2026,1443
13121,足立区,25～29,50160,26306,23854,44906,23379,21527,5254,2927,2327
13121,足立区,30～34,43963,23038,20925,38792,20367,18425,5171,2671,2500
13121,足立区,35～39,42332,22185,20147,38205,20107,18098,4127,2078,2049
13121,足立区,40～44,45200,23452,21748,41594,21835,19759,3606,1617,1989
13121,足立区,45～49,52142,27205,24937,49360,26036,23324,2782,1169,1613
13121,足立区,50～54,59750,31396,28354,57120,30395,26725,2630,1001,1629
13121,足立区,55～59,50731,26668,24063,48626,25961,22665,2105,707,1398
13121,足立区,60～64,39119,20552,18567,37449,19946,17503,1670,606,1064
13121,足立区,65～69,32705,16738,15967,31589,16296,15293,1116,442,674
13121,足立区,70～74,38032,18531,19501,37315,18229,19086,717,302,415
13121,足立区,75～79,35926,16129,19797,35467,15925,19542,459,204,255
13121,足立区,80～84,31951,12824,19127,31637,12698,18939,314,126,188
13121,足立区,85～89,20303,7324,12979,20125,7262,12863,178,62,116
13121,足立区,90～94,8314,2394,5920,8267,2379,5888,47,15,32
13121,足立区,95～99,1779,389,1390,1765,387,1378,14,2,12
13121,足立区,100以上,250,30,220,249,29,220,1,1,-
13122,葛飾区,総数,467000,232534,234466,440162,219365,220797,26838,13169,13669
13122,葛飾区,0～4,15364,7935,7429,14253,7354,6899,1111,581,530
13122,葛飾区,5～9,17414,8921,8493,16353,8375,7978,1061,546,515
13122,葛飾区,10～14,18015,9260,8755,17139,8801,8338,876,459,417
13122,葛飾区,15～19,18573,9573,9000,17413,8948,8465,1160,625,535
13122,葛飾区,20～24,27176,13821,13355,24334,12265,12069,2842,1556,1286
13122,葛飾区,25～29,32728,16629,16099,28928,14599,14329,3800,2030,1770
13122,葛飾区,30～34,29389,15134,14255,25663,13190,12473,3726,1944,1782
13122,葛飾区,35～39,29506,15306,14200,26495,13791,12704,3011,1515,1496
13122,葛飾区,40～44,30944,16068,14876,28345,14826,13519,2599,1242,1357
13122,葛飾区,45～49,34731,18145,16586,32940,17308,15632,1791,837,954
13122,葛飾区,50～54,38715,20121,18594,37229,19554,17675,1486,567,919
13122,葛飾区,55～59,33793,17452,16341,32585,17015,15570,1208,437,771
13122,葛飾区,60～64,27262,14145,13117,26413,13845,12568,849,300,549
13122,葛飾区,65～69,23268,11918,11350,22725,11702,11023,543,216,327
13122,葛飾区,70～74,25723,12657,13066,25393,12517,12876,330,140,190
13122,葛飾区,75～79,23294,10679,12615,23075,10583,12492,219,96,123
13122,葛飾区,80～84,19728,7878,11850,19595,7828,11767,133,50,83
13122,葛飾区,85～89,13479,4715,8764,13422,4699,8723,57,16,41
13122,葛飾区,90～94,6147,1798,4349,6124,1791,4333,23,7,16
13122,葛飾区,95～99,1549,352,1197,1538,348,1190,11,4,7
13122,葛飾区,100以上,202,27,175,200,26,174,2,1,1
13123,江戸川区,総数,689961,347127,342834,647043,325720,321323,42918,21407,21511
13123,江戸川区,0～4,23884,12253,11631,21903,11216,10687,1981,1037,944
13123,江戸川区,5～9,27795,14158,13637,25643,13045,12598,2152,1113,1039
13123,江戸川区,10～14,29461,15147,14314,27639,14208,13431,1822,939,883
13123,江戸川区,15～19,31494,15982,15512,29642,14960,14682,1852,1022,830
13123,江戸川区,20～24,42145,21568,20577,37897,19120,18777,4248,2448,1800
13123,江戸川区,25～29,48452,25133,23319,42694,21996,20698,5758,3137,2621
13123,江戸川区,30～34,44032,22975,21057,38259,19900,18359,5773,3075,2698
13123,江戸川区,35～39,44648,23296,21352,39587,20716,18871,5061,2580,2481
13123,江戸川区,40～44,46566,24235,22331,42245,22131,20114,4321,2104,2217
13123,江戸川区,45～49,53362,27723,25639,50423,26351,24072,2939,1372,1567
13123,江戸川区,50～54,61268,31807,29461,58824,30844,27980,2444,963,1481
13123,江戸川区,55～59,51814,27405,24409,50042,26776,23266,1772,629,1143
13123,江戸川区,60～64,38140,20341,17799,36978,19953,17025,1162,388,774
13123,江戸川区,65～69,29926,15438,14488,29182,15176,14006,744,262,482
13123,江戸川区,70～74,33602,16395,17207,33169,16230,16939,433,165,268
13123,江戸川区,75～79,31364,14090,17274,31154,14012,17142,210,78,132
13123,江戸川区,80～84,26500,10697,15803,26364,10645,15719,136,52,84
13123,江戸川区,85～89,16855,6096,10759,16782,6066,10716,73,30,43
13123,江戸川区,90～94,6826,2035,4791,6801,2026,4775,25,9,16
13123,江戸川区,95～99,1588,312,1276,1578,310,1268,10,2,8
13123,江戸川区,100以上,239,41,198,237,39,198,2,2,-
13200,市部,総数,4190134,2062443,2127691,4087157,2012212,2074945,102977,50231,52746
13200,市部,0～4,137044,70246,66798,133978,68658,65320,3066,1588,1478
13200,市部,5～9,170304,87382,82922,167335,85850,81485,2969,1532,1437
13200,市部,10～14,178966,92093,86873,176534,90834,85700,2432,1259,1173
13200,市部,15～19,190083,97086,92997,186337,95119,91218,3746,1967,1779
13200,市部,20～24,234401,119356,115045,219699,111552,108147,14702,7804,6898
13200,市部,25～29,230653,117589,113064,214906,108903,106003,15747,8686,7061
13200,市部,30～34,222013,113647,108366,209468,106816,102652,12545,6831,5714
13200,市部,35～39,248998,127544,121454,239078,122453,116625,9920,5091,4829
13200,市部,40～44,277093,141989,135104,268573,138178,130395,8520,3811,4709
13200,市部,45～49,317487,161937,155550,310550,159021,151529,6937,2916,4021
13200,市部,50～54,353591,179930,173661,347053,177481,169572,6538,2449,4089
13200,市部,55～59,309247,158995,150252,303563,156877,146686,5684,2118,3566
13200,市部,60～64,249327,126717,122610,245327,125130,120197,4000,1587,2413
13200,市部,65～69,213402,105303,108099,210926,104289,106637,2476,1014,1462
13200,市部,70～74,245292,115784,129508,243768,115090,128678,1524,694,830
13200,市部,75～79,227494,101359,126135,226486,100914,125572,1008,445,563
13200,市部,80～84,188437,78101,110336,187823,77848,109975,614,253,361
13200,市部,85～89,120621,45671,74950,120263,45545,74718,358,126,232
13200,市部,90～94,57565,17924,39641,57424,17880,39544,141,44,97
13200,市部,95～99,15816,3513,12303,15774,3498,12276,42,15,27
13200,市部,100以上,2300,277,2023,2292,276,2016,8,1,7
13201,八王子市,総数,560692,280146,280546,545227,272505,272722,15465,7641,7824
13201,八王子市,0～4,15505,7956,7549,15108,7754,7354,397,202,195
13201,八王子市,5～9,20231,10497,9734,19850,10295,9555,381,202,179
13201,八王子市,10～14,23282,12025,11257,22931,11844,11087,351,181,170
13201,八王子市,15～19,27303,14109,13194,26678,13765,12913,625,344,281
13201,八王子市,20～24,36307,19238,17069,33203,17554,15649,3104,1684,1420
13201,八王子市,25～29,29471,15703,13768,26965,14258,12707,2506,1445,1061
13201,八王子市,30～34,26766,14340,12426,25101,13384,11717,1665,956,709
13201,八王子市,35～39,29758,15617,14141,28514,14975,13539,1244,642,602
13201,八王子市,40～44,34305,17804,16501,33151,17321,15830,1154,483,671
13201,八王子市,45～49,40994,21130,19864,40050,20794,19256,944,336,608
13201,八王子市,50～54,46670,24078,22592,45684,23726,21958,986,352,634
13201,八王子市,55～59,40807,21132,19675,39977,20818,19159,830,314,516
13201,八王子市,60～64,33520,17109,16411,33011,16911,16100,509,198,311
13201,八王子市,65～69,30532,15044,15488,30201,14914,15287,331,130,201
13201,八王子市,70～74,36989,17515,19474,36790,17431,19359,199,84,115
13201,八王子市,75～79,34051,15454,18597,33940,15408,18532,111,46,65
13201,八王子市,80～84,27696,12004,15692,27626,11978,15648,70,26,44
13201,八王子市,85～89,16620,6596,10024,16584,6586,9998,36,10,26
13201,八王子市,90～94,7509,2324,5185,7493,2320,5173,16,4,12
13201,八王子市,95～99,2060,428,1632,2055,426,1629,5,2,3
13201,八王子市,100以上,316,43,273,315,43,272,1,-,1
13202,立川市,総数,185825,91979,93846,180361,89426,90935,5464,2553,2911
13202,立川市,0～4,6239,3177,3062,6117,3107,3010,122,70,52
13202,立川市,5～9,7416,3800,3616,7274,3723,3551,142,77,65
13202,立川市,10～14,7539,3902,3637,7425,3839,3586,114,63,51
13202,立川市,15～19,7826,3941,3885,7680,3866,3814,146,75,71
13202,立川市,20～24,10467,5107,5360,9759,4768,4991,708,339,369
13202,立川市,25～29,11901,6127,5774,10966,5674,5292,935,453,482
13202,立川市,30～34,11124,5807,5317,10420,5433,4987,704,374,330
13202,立川市,35～39,11619,6105,5514,11079,5807,5272,540,298,242
13202,立川市,40～44,12534,6546,5988,12130,6391,5739,404,155,249
13202,立川市,45～49,14019,7349,6670,13615,7186,6429,404,163,241
13202,立川市,50～54,15671,8045,7626,15310,7911,7399,361,134,227
13202,立川市,55～59,13124,6872,6252,12856,6778,6078,268,94,174
13202,立川市,60～64,10250,5277,4973,10040,5197,4843,210,80,130
13202,立川市,65～69,9095,4491,4604,8947,4422,4525,148,69,79
13202,立川市,70～74,10524,4979,5545,10416,4934,5482,108,45,63
13202,立川市,75～79,9990,4373,5617,9912,4342,5570,78,31,47
13202,立川市,80～84,8283,3385,4898,8243,3365,4878,40,20,20
13202,立川市,85～89,5113,1834,3279,5091,1824,3267,22,10,12
13202,立川市,90～94,2380,716,1664,2372,714,1658,8,2,6
13202,立川市,95～99,634,141,493,632,140,492,2,1,1
13202,立川市,100以上,77,5,72,77,5,72,-,-,-
13203,武蔵野市,総数,147809,70765,77044,144090,68868,75222,3719,1897,1822
13203,武蔵野市,0～4,5238,2667,2571,5137,2607,2530,101,60,41
13203,武蔵野市,5～9,6198,3231,2967,6083,3164,2919,115,67,48
13203,武蔵野市,10～14,5937,3063,2874,5858,3025,2833,79,38,41
13203,武蔵野市,15～19,5838,2989,2849,5709,2911,2798,129,78,51
13203,武蔵野市,20～24,7786,3801,3985,7268,3541,3727,518,260,258
13203,武蔵野市,25～29,9807,4840,4967,9252,4566,4686,555,274,281
13203,武蔵野市,30～34,9615,4825,4790,9153,4596,4557,462,229,233
13203,武蔵野市,35～39,10352,5144,5208,9917,4925,4992,435,219,216
13203,武蔵野市,40～44,11141,5496,5645,10765,5308,5457,376,188,188
13203,武蔵野市,45～49,11727,5684,6043,11456,5551,5905,271,133,138
13203,武蔵野市,50～54,11875,5738,6137,11669,5636,6033,206,102,104
13203,武蔵野市,55～59,10411,5098,5313,10247,5010,5237,164,88,76
13203,武蔵野市,60～64,8538,4177,4361,8423,4119,4304,115,58,57
13203,武蔵野市,65～69,6980,3316,3664,6901,3276,3625,79,40,39
13203,武蔵野市,70～74,7354,3436,3918,7310,3408,3902,44,28,16
13203,武蔵野市,75～79,6819,2967,3852,6785,2947,3838,34,20,14
13203,武蔵野市,80～84,5302,2145,3157,5286,2135,3151,16,10,6
13203,武蔵野市,85～89,3849,1377,2472,3841,1375,2466,8,2,6
13203,武蔵野市,90～94,2180,595,1585,2170,593,1577,10,2,8
13203,武蔵野市,95～99,737,156,581,735,155,580,2,1,1
13203,武蔵野市,100以上,125,20,105,125,20,105,-,-,-
13204,三鷹市,総数,189959,92506,97453,185627,90361,95266,4332,2145,2187
13204,三鷹市,0～4,6541,3355,3186,6445,3304,3141,96,51,45
13204,三鷹市,5～9,8387,4336,4051,8281,4281,4000,106,55,51
13204,三鷹市,10～14,8454,4323,4131,8378,4284,4094,76,39,37
13204,三鷹市,15～19,8217,4191,4026,8071,4115,3956,146,76,70
13204,三鷹市,20～24,10571,5241,5330,9946,4961,4985,625,280,345
13204,三鷹市,25～29,11565,5816,5749,10882,5462,5420,683,354,329
13204,三鷹市,30～34,11009,5543,5466,10486,5277,5209,523,266,257
13204,三鷹市,35～39,12738,6350,6388,12256,6096,6160,482,254,228
13204,三鷹市,40～44,14022,7086,6936,13688,6907,6781,334,179,155
13204,三鷹市,45～49,15252,7518,7734,14921,7361,7560,331,157,174
13204,三鷹市,50～54,16118,8055,8063,15874,7941,7933,244,114,130
13204,三鷹市,55～59,13970,7110,6860,13754,7015,6739,216,95,121
13204,三鷹市,60～64,11148,5610,5538,10968,5520,5448,180,90,90
13204,三鷹市,65～69,8697,4268,4429,8593,4223,4370,104,45,59
13204,三鷹市,70～74,9346,4455,4891,9264,4415,4849,82,40,42
13204,三鷹市,75～79,8668,3811,4857,8617,3786,4831,51,25,26
13204,三鷹市,80～84,6916,2773,4143,6890,2760,4130,26,13,13
13204,三鷹市,85～89,4755,1672,3083,4735,1662,3073,20,10,10
13204,三鷹市,90～94,2658,798,1860,2655,798,1857,3,-,3
13204,三鷹市,95～99,803,183,620,800,181,619,3,2,1
13204,三鷹市,100以上,124,12,112,123,12,111,1,-,1
13205,青梅市,総数,129468,65036,64432,126916,63834,63082,2552,1202,1350
13205,青梅市,0～4,3200,1623,1577,3126,1582,1544,74,41,33
13205,青梅市,5～9,4192,2153,2039,4120,2114,2006,72,39,33
13205,青梅市,10～14,4946,2589,2357,4887,2557,2330,59,32,27
13205,青梅市,15～19,5644,2837,2807,5555,2790,2765,89,47,42
13205,青梅市,20～24,6219,3323,2896,5969,3174,2795,250,149,101
13205,青梅市,25～29,5829,3140,2689,5407,2886,2521,422,254,168
13205,青梅市,30～34,5642,3101,2541,5341,2923,2418,301,178,123
13205,青梅市,35～39,6414,3456,2958,6191,3346,2845,223,110,113
13205,青梅市,40～44,7481,3890,3591,7284,3813,3471,197,77,120
13205,青梅市,45～49,9109,4750,4359,8947,4699,4248,162,51,111
13205,青梅市,50～54,10822,5757,5065,10633,5706,4927,189,51,138
13205,青梅市,55～59,9776,5077,4699,9588,5020,4568,188,57,131
13205,青梅市,60～64,8647,4507,4140,8524,4465,4059,123,42,81
13205,青梅市,65～69,8357,4197,4160,8267,4171,4096,90,26,64
13205,青梅市,70～74,10360,5083,5277,10310,5062,5248,50,21,29
13205,青梅市,75～79,9007,4120,4887,8976,4106,4870,31,14,17
13205,青梅市,80～84,7147,3180,3967,7127,3171,3956,20,9,11
13205,青梅市,85～89,4112,1608,2504,4103,1604,2499,9,4,5
13205,青梅市,90～94,1891,522,1369,1888,522,1366,3,-,3
13205,青梅市,95～99,594,116,478,594,116,478,-,-,-
13205,青梅市,100以上,79,7,72,79,7,72,-,-,-
13206,府中市,総数,260078,130030,130048,254091,127295,126796,5987,2735,3252
13206,府中市,0～4,8680,4437,4243,8506,4341,4165,174,96,78
13206,府中市,5～9,11168,5710,5458,10994,5614,5380,174,96,78
13206,府中市,10～14,11880,6060,5820,11742,5980,5762,138,80,58
13206,府中市,15～19,12214,6292,5922,12018,6193,5825,196,99,97
13206,府中市,20～24,14991,7729,7262,14066,7336,6730,925,393,532
13206,府中市,25～29,15186,7829,7357,14228,7336,6892,958,493,465
13206,府中市,30～34,14253,7399,6854,13561,7026,6535,692,373,319
13206,府中市,35～39,16384,8474,7910,15844,8199,7645,540,275,265
13206,府中市,40～44,18189,9342,8847,17712,9140,8572,477,202,275
13206,府中市,45～49,20636,10671,9965,20185,10505,9680,451,166,285
13206,府中市,50～54,22944,11840,11104,22578,11715,10863,366,125,241
13206,府中市,55～59,19885,10393,9492,19549,10283,9266,336,110,226
13206,府中市,60～64,15103,7941,7162,14861,7851,7010,242,90,152
13206,府中市,65～69,12255,6228,6027,12125,6174,5951,130,54,76
13206,府中市,70～74,13528,6552,6976,13448,6516,6932,80,36,44
13206,府中市,75～79,12158,5390,6768,12119,5371,6748,39,19,20
13206,府中市,80～84,9926,4110,5816,9891,4092,5799,35,18,17
13206,府中市,85～89,6453,2395,4058,6436,2390,4046,17,5,12
13206,府中市,90～94,3200,993,2207,3189,990,2199,11,3,8
13206,府中市,95～99,928,233,695,922,231,691,6,2,4
13206,府中市,100以上,117,12,105,117,12,105,-,-,-
13207,昭島市,総数,114516,56910,57606,111302,55395,55907,3214,1515,1699
13207,昭島市,0～4,4084,2095,1989,3978,2034,1944,106,61,45
13207,昭島市,5～9,4813,2424,2389,4725,2383,2342,88,41,47
13207,昭島市,10～14,4901,2494,2407,4827,2452,2375,74,42,32
13207,昭島市,15～19,4877,2474,2403,4756,2411,2345,121,63,58
13207,昭島市,20～24,5610,2919,2691,5260,2710,2550,350,209,141
13207,昭島市,25～29,6217,3264,2953,5808,3054,2754,409,210,199
13207,昭島市,30～34,6410,3320,3090,6012,3119,2893,398,201,197
13207,昭島市,35～39,7093,3714,3379,6794,3554,3240,299,160,139
13207,昭島市,40～44,7721,4006,3715,7469,3903,3566,252,103,149
13207,昭島市,45～49,8658,4578,4080,8422,4480,3942,236,98,138
13207,昭島市,50～54,9236,4784,4452,8990,4698,4292,246,86,160
13207,昭島市,55～59,7924,4076,3848,7726,4006,3720,198,70,128
13207,昭島市,60～64,6648,3387,3261,6502,3329,3173,146,58,88
13207,昭島市,65～69,6353,3100,3253,6239,3052,3187,114,48,66
13207,昭島市,70～74,7422,3554,3868,7358,3527,3831,64,27,37
13207,昭島市,75～79,6573,3038,3535,6525,3016,3509,48,22,26
13207,昭島市,80～84,5034,2053,2981,4999,2045,2954,35,8,27
13207,昭島市,85～89,3078,1144,1934,3057,1140,1917,21,4,17
13207,昭島市,90～94,1426,396,1030,1419,392,1027,7,4,3
13207,昭島市,95～99,371,84,287,369,84,285,2,-,2
13207,昭島市,100以上,67,6,61,67,6,61,-,-,-
13208,調布市,総数,238774,116031,122743,233665,113453,120212,5109,2578,2531
13208,調布市,0～4,8551,4418,4133,8404,4333,4071,147,85,62
13208,調布市,5～9,10293,5172,5121,10174,5114,5060,119,58,61
13208,調布市,10～14,9968,5089,4879,9880,5050,4830,88,39,49
13208,調布市,15～19,10153,5154,4999,10005,5080,4925,148,74,74
13208,調布市,20～24,13369,6760,6609,12856,6449,6407,513,311,202
13208,調布市,25～29,15228,7452,7776,14470,7010,7460,758,442,316
13208,調布市,30～34,14261,6992,7269,13588,6633,6955,673,359,314
13208,調布市,35～39,15974,7927,8047,15408,7623,7785,566,304,262
13208,調布市,40～44,17441,8847,8594,17004,8646,8358,437,201,236
13208,調布市,45～49,19273,9655,9618,18908,9487,9421,365,168,197
13208,調布市,50～54,20633,10329,10304,20302,10182,10120,331,147,184
13208,調布市,55～59,17814,8939,8875,17538,8847,8691,276,92,184
13208,調布市,60～64,13732,6969,6763,13498,6869,6629,234,100,134
13208,調布市,65～69,10721,5338,5383,10557,5267,5290,164,71,93
13208,調布市,70～74,11634,5413,6221,11522,5351,6171,112,62,50
13208,調布市,75～79,10604,4638,5966,10541,4618,5923,63,20,43
13208,調布市,80～84,8847,3527,5320,8797,3504,5293,50,23,27
13208,調布市,85～89,6159,2262,3897,6118,2247,3871,41,15,26
13208,調布市,90～94,3187,956,2231,3168,949,2219,19,7,12
13208,調布市,95～99,832,182,650,829,182,647,3,-,3
13208,調布市,100以上,100,12,88,98,12,86,2,-,2
13209,町田市,総数,430380,210105,220275,421481,205752,215729,8899,4353,4546
13209,町田市,0～4,13469,6929,6540,13113,6744,6369,356,185,171
13209,町田市,5～9,17037,8722,8315,16692,8555,8137,345,167,178
13209,町田市,10～14,19003,9802,9201,18784,9690,9094,219,112,107
13209,町田市,15～19,21043,10652,10391,20827,10543,10284,216,109,107
13209,町田市,20～24,23915,12191,11724,22848,11654,11194,1067,537,530
13209,町田市,25～29,20714,10541,10173,19381,9826,9555,1333,715,618
13209,町田市,30～34,19781,10065,9716,18614,9429,9185,1167,636,531
13209,町田市,35～39,23083,11823,11260,22181,11366,10815,902,457,445
13209,町田市,40～44,26840,13605,13235,26030,13238,12792,810,367,443
13209,町田市,45～49,32571,16393,16178,31975,16109,15866,596,284,312
13209,町田市,50～54,38273,19370,18903,37668,19132,18536,605,238,367
13209,町田市,55～59,32154,16513,15641,31693,16326,15367,461,187,274
13209,町田市,60～64,25026,12531,12495,24689,12398,12291,337,133,204
13209,町田市,65～69,22194,10783,11411,22011,10698,11313,183,85,98
13209,町田市,70～74,26047,12035,14012,25934,11986,13948,113,49,64
13209,町田市,75～79,25413,11158,14255,25321,11105,14216,92,53,39
13209,町田市,80～84,22128,9163,12965,22072,9142,12930,56,21,35
13209,町田市,85～89,13625,5383,8242,13601,5373,8228,24,10,14
13209,町田市,90～94,6215,2059,4156,6205,2056,4149,10,3,7
13209,町田市,95～99,1594,355,1239,1589,351,1238,5,4,1
13209,町田市,100以上,255,32,223,253,31,222,2,1,1
13209,町田市,不詳者,-,-,-,-,-,-,-,-,-
13210,小金井市,総数,124614,61291,63323,121402,59678,61724,3212,1613,1599
13210,小金井市,0～4,4868,2442,2426,4754,2380,2374,114,62,52
13210,小金井市,5～9,5651,2921,2730,5536,2871,2665,115,50,65
13210,小金井市,10～14,5163,2680,2483,5067,2632,2435,96,48,48
13210,小金井市,15～19,5026,2598,2428,4929,2553,2376,97,45,52
13210,小金井市,20～24,7531,3842,3689,7108,3613,3495,423,229,194
13210,小金井市,25～29,8279,4111,4168,7706,3795,3911,573,316,257
13210,小金井市,30～34,8134,4004,4130,7701,3774,3927,433,230,203
13210,小金井市,35～39,8699,4336,4363,8327,4156,4171,372,180,192
13210,小金井市,40～44,9044,4656,4388,8769,4525,4244,275,131,144
13210,小金井市,45～49,9285,4722,4563,9089,4632,4457,196,90,106
13210,小金井市,50～54,9561,4748,4813,9377,4670,4707,184,78,106
13210,小金井市,55～59,8869,4511,4358,8740,4459,4281,129,52,77
13210,小金井市,60～64,7643,3914,3729,7541,3866,3675,102,48,54
13210,小金井市,65～69,5898,2996,2902,5851,2974,2877,47,22,25
13210,小金井市,70～74,6152,2973,3179,6128,2959,3169,24,14,10
13210,小金井市,75～79,5478,2521,2957,5464,2514,2950,14,7,7
13210,小金井市,80～84,4140,1643,2497,4128,1636,2492,12,7,5
13210,小金井市,85～89,2986,1069,1917,2982,1066,1916,4,3,1
13210,小金井市,90～94,1629,492,1137,1628,491,1137,1,1,-
13210,小金井市,95～99,512,105,407,511,105,406,1,-,1
13210,小金井市,100以上,66,7,59,66,7,59,-,-,-
13211,小平市,総数,196913,96365,100548,191141,93601,97540,5772,2764,3008
13211,小平市,0～4,7239,3700,3539,7081,3615,3466,158,85,73
13211,小平市,5～9,8937,4642,4295,8794,4571,4223,143,71,72
13211,小平市,10～14,8927,4567,4360,8810,4513,4297,117,54,63
13211,小平市,15～19,8994,4632,4362,8663,4471,4192,331,161,170
13211,小平市,20～24,11665,5744,5921,10386,5127,5259,1279,617,662
13211,小平市,25～29,10827,5486,5341,9996,5033,4963,831,453,378
13211,小平市,30～34,10830,5359,5471,10170,5024,5146,660,335,325
13211,小平市,35～39,12259,6207,6052,11706,5937,5769,553,270,283
13211,小平市,40～44,13467,6958,6509,13070,6777,6293,397,181,216
13211,小平市,45～49,14792,7513,7279,14483,7374,7109,309,139,170
13211,小平市,50～54,15818,7994,7824,15554,7892,7662,264,102,162
13211,小平市,55～59,14390,7325,7065,14122,7213,6909,268,112,156
13211,小平市,60～64,12100,6034,6066,11924,5963,5961,176,71,105
13211,小平市,65～69,9758,4823,4935,9648,4776,4872,110,47,63
13211,小平市,70～74,10347,4910,5437,10276,4875,5401,71,35,36
13211,小平市,75～79,9496,4230,5266,9448,4212,5236,48,18,30
13211,小平市,80～84,7840,3148,4692,7813,3141,4672,27,7,20
13211,小平市,85～89,5544,2047,3497,5525,2044,3481,19,3,16
13211,小平市,90～94,2790,845,1945,2782,842,1940,8,3,5
13211,小平市,95～99,778,186,592,776,186,590,2,-,2
13211,小平市,100以上,115,15,100,114,15,99,1,-,1
13212,日野市,総数,187494,93731,93763,183715,91821,91894,3779,1910,1869
13212,日野市,0～4,6518,3441,3077,6417,3399,3018,101,42,59
13212,日野市,5～9,7886,4070,3816,7787,4012,3775,99,58,41
13212,日野市,10～14,8194,4195,3999,8105,4151,3954,89,44,45
13212,日野市,15～19,8445,4400,4045,8304,4323,3981,141,77,64
13212,日野市,20～24,10530,5435,5095,9919,5091,4828,611,344,267
13212,日野市,25～29,10676,5568,5108,10033,5199,4834,643,369,274
13212,日野市,30～34,10497,5482,5015,10009,5195,4814,488,287,201
13212,日野市,35～39,11413,5952,5461,11087,5770,5317,326,182,144
13212,日野市,40～44,12526,6539,5987,12208,6404,5804,318,135,183
13212,日野市,45～49,14171,7299,6872,13913,7197,6716,258,102,156
13212,日野市,50～54,15988,8341,7647,15771,8259,7512,217,82,135
13212,日野市,55～59,13693,7264,6429,13520,7201,6319,173,63,110
13212,日野市,60～64,10393,5353,5040,10262,5302,4960,131,51,80
13212,日野市,65～69,8574,4322,4252,8498,4290,4208,76,32,44
13212,日野市,70～74,10480,4796,5684,10439,4780,5659,41,16,25
13212,日野市,75～79,10036,4438,5598,9997,4424,5573,39,14,25
13212,日野市,80～84,8761,3687,5074,8742,3680,5062,19,7,12
13212,日野市,85～89,5397,2106,3291,5388,2101,3287,9,5,4
13212,日野市,90～94,2547,875,1672,2547,875,1672,-,-,-
13212,日野市,95～99,676,157,519,676,157,519,-,-,-
13212,日野市,100以上,93,11,82,93,11,82,-,-,-
13213,東村山市,総数,151751,73834,77917,148041,72051,75990,3710,1783,1927
13213,東村山市,0～4,5062,2626,2436,4916,2557,2359,146,69,77
13213,東村山市,5～9,5829,2956,2873,5687,2878,2809,142,78,64
13213,東村山市,10～14,6404,3344,3060,6306,3297,3009,98,47,51
13213,東村山市,15～19,6802,3468,3334,6668,3402,3266,134,66,68
13213,東村山市,20～24,7712,3898,3814,7308,3658,3650,404,240,164
13213,東村山市,25～29,7529,3727,3802,7065,3446,3619,464,281,183
13213,東村山市,30～34,7672,3795,3877,7200,3563,3637,472,232,240
13213,東村山市,35～39,8722,4408,4314,8319,4197,4122,403,211,192
13213,東村山市,40～44,9670,4954,4716,9330,4799,4531,340,155,185
13213,東村山市,45～49,11114,5712,5402,10847,5604,5243,267,108,159
13213,東村山市,50～54,13042,6607,6435,12763,6513,6250,279,94,185
13213,東村山市,55～59,11439,5768,5671,11229,5702,5527,210,66,144
13213,東村山市,60～64,9687,4925,4762,9527,4867,4660,160,58,102
13213,東村山市,65～69,8183,4013,4170,8108,3982,4126,75,31,44
13213,東村山市,70～74,9229,4374,4855,9189,4358,4831,40,16,24
13213,東村山市,75～79,8469,3678,4791,8431,3655,4776,38,23,15
13213,東村山市,80～84,7248,2980,4268,7224,2975,4249,24,5,19
13213,東村山市,85～89,4847,1704,3143,4840,1702,3138,7,2,5
13213,東村山市,90～94,2406,749,1657,2402,749,1653,4,-,4
13213,東村山市,95～99,600,139,461,598,138,460,2,1,1
13213,東村山市,100以上,85,9,76,84,9,75,1,-,1
13214,国分寺市,総数,128762,63157,65605,125976,61803,64173,2786,1354,1432
13214,国分寺市,0～4,5042,2578,2464,4949,2528,2421,93,50,43
13214,国分寺市,5～9,5712,2952,2760,5618,2902,2716,94,50,44
13214,国分寺市,10～14,5312,2797,2515,5254,2765,2489,58,32,26
13214,国分寺市,15～19,5479,2761,2718,5399,2720,2679,80,41,39
13214,国分寺市,20～24,7393,3608,3785,7065,3458,3607,328,150,178
13214,国分寺市,25～29,8419,4232,4187,7890,3960,3930,529,272,257
13214,国分寺市,30～34,8097,4132,3965,7710,3927,3783,387,205,182
13214,国分寺市,35～39,8890,4635,4255,8603,4497,4106,287,138,149
13214,国分寺市,40～44,8666,4380,4286,8414,4259,4155,252,121,131
13214,国分寺市,45～49,9737,4915,4822,9553,4823,4730,184,92,92
13214,国分寺市,50～54,10245,5029,5216,10127,4980,5147,118,49,69
13214,国分寺市,55～59,9423,4769,4654,9286,4716,4570,137,53,84
13214,国分寺市,60～64,7892,4053,3839,7791,4007,3784,101,46,55
13214,国分寺市,65～69,6140,3070,3070,6081,3046,3035,59,24,35
13214,国分寺市,70～74,6223,2903,3320,6187,2887,3300,36,16,20
13214,国分寺市,75～79,5706,2498,3208,5686,2491,3195,20,7,13
13214,国分寺市,80～84,4654,1849,2805,4643,1844,2799,11,5,6
13214,国分寺市,85～89,3418,1292,2126,3409,1290,2119,9,2,7
13214,国分寺市,90～94,1775,570,1205,1772,569,1203,3,1,2
13214,国分寺市,95～99,472,122,350,472,122,350,-,-,-
13214,国分寺市,100以上,67,12,55,67,12,55,-,-,-
13215,国立市,総数,75889,36793,39096,73972,35872,38100,1917,921,996
13215,国立市,0～4,2287,1172,1115,2239,1150,1089,48,22,26
13215,国立市,5～9,3092,1617,1475,3033,1585,1448,59,32,27
13215,国立市,10～14,2993,1566,1427,2922,1533,1389,71,33,38
13215,国立市,15～19,3226,1646,1580,3172,1621,1551,54,25,29
13215,国立市,20～24,4490,2173,2317,4297,2075,2222,193,98,95
13215,国立市,25～29,4696,2344,2352,4330,2167,2163,366,177,189
13215,国立市,30～34,4159,2121,2038,3926,1990,1936,233,131,102
13215,国立市,35～39,4497,2247,2250,4321,2169,2152,176,78,98
13215,国立市,40～44,4979,2495,2484,4818,2412,2406,161,83,78
13215,国立市,45～49,5458,2690,2768,5321,2630,2691,137,60,77
13215,国立市,50～54,6144,3020,3124,6029,2976,3053,115,44,71
13215,国立市,55～59,6220,3118,3102,6115,3073,3042,105,45,60
13215,国立市,60～64,5241,2662,2579,5170,2629,2541,71,33,38
13215,国立市,65～69,4121,2015,2106,4064,1988,2076,57,27,30
13215,国立市,70～74,4178,2011,2167,4152,1996,2156,26,15,11
13215,国立市,75～79,3757,1631,2126,3734,1624,2110,23,7,16
13215,国立市,80～84,2962,1151,1811,2951,1144,1807,11,7,4
13215,国立市,85～89,2042,727,1315,2036,725,1311,6,2,4
13215,国立市,90～94,1002,316,686,998,314,684,4,2,2
13215,国立市,95～99,303,65,238,302,65,237,1,-,1
13215,国立市,100以上,42,6,36,42,6,36,-,-,-
13218,福生市,総数,56512,28369,28143,52374,26296,26078,4138,2073,2065
13218,福生市,0～4,1642,841,801,1474,754,720,168,87,81
13218,福生市,5～9,1831,907,924,1735,862,873,96,45,51
13218,福生市,10～14,2010,1023,987,1936,979,957,74,44,30
13218,福生市,15～19,2311,1195,1116,2091,1073,1018,220,122,98
13218,福生市,20～24,3375,1794,1581,2604,1376,1228,771,418,353
13218,福生市,25～29,3564,1893,1671,2901,1552,1349,663,341,322
13218,福生市,30～34,3370,1810,1560,2849,1508,1341,521,302,219
13218,福生市,35～39,3143,1712,1431,2832,1539,1293,311,173,138
13218,福生市,40～44,3343,1782,1561,3084,1667,1417,259,115,144
13218,福生市,45～49,3887,2064,1823,3680,1965,1715,207,99,108
13218,福生市,50～54,4543,2386,2157,4302,2274,2028,241,112,129
13218,福生市,55～59,4229,2157,2072,3991,2071,1920,238,86,152
13218,福生市,60～64,3678,1830,1848,3543,1784,1759,135,46,89
13218,福生市,65～69,3420,1769,1651,3315,1731,1584,105,38,67
13218,福生市,70～74,3793,1862,1931,3731,1843,1888,62,19,43
13218,福生市,75～79,3201,1483,1718,3167,1470,1697,34,13,21
13218,福生市,80～84,2555,1036,1519,2539,1030,1509,16,6,10
13218,福生市,85～89,1587,570,1017,1577,565,1012,10,5,5
13218,福生市,90～94,789,209,580,786,208,578,3,1,2
13218,福生市,95～99,210,46,164,206,45,161,4,1,3
13218,福生市,100以上,31,-,31,31,-,31,-,-,-
13219,狛江市,総数,82102,39623,42479,80610,38841,41769,1492,782,710
13219,狛江市,0～4,2845,1443,1402,2809,1424,1385,36,19,17
13219,狛江市,5～9,3463,1787,1676,3432,1769,1663,31,18,13
13219,狛江市,10～14,3248,1651,1597,3210,1632,1578,38,19,19
13219,狛江市,15～19,3171,1623,1548,3131,1604,1527,40,19,21
13219,狛江市,20～24,4392,2219,2173,4242,2120,2122,150,99,51
13219,狛江市,25～29,5129,2440,2689,4894,2305,2589,235,135,100
13219,狛江市,30～34,4619,2182,2437,4388,2055,2333,231,127,104
13219,狛江市,35～39,5213,2523,2690,5067,2449,2618,146,74,72
13219,狛江市,40～44,5936,2942,2994,5783,2867,2916,153,75,78
13219,狛江市,45～49,6400,3245,3155,6287,3196,3091,113,49,64
13219,狛江市,50～54,6793,3360,3433,6684,3312,3372,109,48,61
13219,狛江市,55～59,6248,3279,2969,6154,3233,2921,94,46,48
13219,狛江市,60～64,4703,2377,2326,4657,2356,2301,46,21,25
13219,狛江市,65～69,3969,1976,1993,3946,1965,1981,23,11,12
13219,狛江市,70～74,4282,2063,2219,4266,2055,2211,16,8,8
13219,狛江市,75～79,4121,1821,2300,4101,1813,2288,20,8,12
13219,狛江市,80～84,3525,1384,2141,3520,1381,2139,5,3,2
13219,狛江市,85～89,2412,847,1565,2409,845,1564,3,2,1
13219,狛江市,90～94,1240,361,879,1237,360,877,3,1,2
13219,狛江市,95～99,355,90,265,355,90,265,-,-,-
13219,狛江市,100以上,38,10,28,38,10,28,-,-,-
13220,東大和市,総数,85085,41786,43299,83692,41192,42500,1393,594,799
13220,東大和市,0～4,2788,1440,1348,2759,1429,1330,29,11,18
13220,東大和市,5～9,3507,1793,1714,3478,1779,1699,29,14,15
13220,東大和市,10～14,3836,1946,1890,3798,1931,1867,38,15,23
13220,東大和市,15～19,3977,2020,1957,3928,1996,1932,49,24,25
13220,東大和市,20～24,4145,2072,2073,4004,1998,2006,141,74,67
13220,東大和市,25～29,3993,2032,1961,3858,1943,1915,135,89,46
13220,東大和市,30～34,4123,2111,2012,3996,2034,1962,127,77,50
13220,東大和市,35～39,4644,2292,2352,4521,2228,2293,123,64,59
13220,東大和市,40～44,5283,2742,2541,5171,2702,2469,112,40,72
13220,東大和市,45～49,6281,3216,3065,6170,3178,2992,111,38,73
13220,東大和市,50～54,7247,3712,3535,7117,3680,3437,130,32,98
13220,東大和市,55～59,6587,3417,3170,6448,3376,3072,139,41,98
13220,東大和市,60～64,5126,2631,2495,5056,2613,2443,70,18,52
13220,東大和市,65～69,4390,2167,2223,4330,2145,2185,60,22,38
13220,東大和市,70～74,5423,2572,2851,5390,2562,2828,33,10,23
13220,東大和市,75～79,5072,2299,2773,5054,2292,2762,18,7,11
13220,東大和市,80～84,4422,1804,2618,4394,1793,2601,28,11,17
13220,東大和市,85～89,2782,1053,1729,2764,1047,1717,18,6,12
13220,東大和市,90～94,1158,402,756,1156,401,755,2,1,1
13220,東大和市,95～99,268,61,207,267,61,206,1,-,1
13220,東大和市,100以上,33,4,29,33,4,29,-,-,-
13221,清瀬市,総数,74596,35904,38692,73120,35229,37891,1476,675,801
13221,清瀬市,0～4,2402,1233,1169,2369,1213,1156,33,20,13
13221,清瀬市,5～9,2920,1465,1455,2875,1441,1434,45,24,21
13221,清瀬市,10～14,3198,1623,1575,3155,1596,1559,43,27,16
13221,清瀬市,15～19,3487,1764,1723,3426,1734,1692,61,30,31
13221,清瀬市,20～24,3917,1865,2052,3792,1803,1989,125,62,63
13221,清瀬市,25～29,3700,1753,1947,3542,1672,1870,158,81,77
13221,清瀬市,30～34,3703,1865,1838,3522,1762,1760,181,103,78
13221,清瀬市,35～39,4148,2092,2056,3999,2020,1979,149,72,77
13221,清瀬市,40～44,4581,2308,2273,4447,2251,2196,134,57,77
13221,清瀬市,45～49,5388,2697,2691,5265,2651,2614,123,46,77
13221,清瀬市,50～54,6412,3256,3156,6278,3201,3077,134,55,79
13221,清瀬市,55～59,5481,2860,2621,5374,2823,2551,107,37,70
13221,清瀬市,60～64,4483,2237,2246,4413,2215,2198,70,22,48
13221,清瀬市,65～69,3691,1814,1877,3647,1798,1849,44,16,28
13221,清瀬市,70～74,4675,2203,2472,4646,2196,2450,29,7,22
13221,清瀬市,75～79,4230,1807,2423,4207,1797,2410,23,10,13
13221,清瀬市,80～84,3874,1528,2346,3866,1526,2340,8,2,6
13221,清瀬市,85～89,2791,1059,1732,2784,1057,1727,7,2,5
13221,清瀬市,90～94,1174,398,776,1172,396,776,2,2,-
13221,清瀬市,95～99,295,72,223,295,72,223,-,-,-
13221,清瀬市,100以上,46,5,41,46,5,41,-,-,-
13222,東久留米市,総数,116512,56487,60025,113889,55327,58562,2623,1160,1463
13222,東久留米市,0～4,3834,1949,1885,3746,1910,1836,88,39,49
13222,東久留米市,5～9,4920,2547,2373,4834,2506,2328,86,41,45
13222,東久留米市,10～14,4928,2492,2436,4818,2440,2378,110,52,58
13222,東久留米市,15～19,5083,2587,2496,4981,2541,2440,102,46,56
13222,東久留米市,20～24,5484,2812,2672,5281,2720,2561,203,92,111
13222,東久留米市,25～29,5361,2625,2736,5103,2491,2612,258,134,124
13222,東久留米市,30～34,5481,2710,2771,5198,2564,2634,283,146,137
13222,東久留米市,35～39,6458,3267,3191,6177,3130,3047,281,137,144
13222,東久留米市,40～44,7340,3743,3597,7054,3618,3436,286,125,161
13222,東久留米市,45～49,8409,4289,4120,8201,4208,3993,208,81,127
13222,東久留米市,50～54,9774,5000,4774,9564,4930,4634,210,70,140
13222,東久留米市,55～59,8586,4397,4189,8390,4328,4062,196,69,127
13222,東久留米市,60～64,7260,3655,3605,7121,3600,3521,139,55,84
13222,東久留米市,65～69,6346,3080,3266,6265,3052,3213,81,28,53
13222,東久留米市,70～74,7369,3458,3911,7324,3428,3896,45,30,15
13222,東久留米市,75～79,7110,3115,3995,7089,3109,3980,21,6,15
13222,東久留米市,80～84,6226,2484,3742,6213,2478,3735,13,6,7
13222,東久留米市,85～89,4152,1554,2598,4144,1552,2592,8,2,6
13222,東久留米市,90～94,1853,604,1249,1849,604,1245,4,-,4
13222,東久留米市,95～99,471,109,362,470,108,362,1,1,-
13222,東久留米市,100以上,67,10,57,67,10,57,-,-,-
13223,武蔵村山市,総数,71018,35225,35793,69005,34381,34624,2013,844,1169
13223,武蔵村山市,0～4,2219,1124,1095,2169,1098,1071,50,26,24
13223,武蔵村山市,5～9,3036,1521,1515,2964,1488,1476,72,33,39
13223,武蔵村山市,10～14,3432,1783,1649,3366,1742,1624,66,41,25
13223,武蔵村山市,15～19,3919,1949,1970,3819,1914,1905,100,35,65
13223,武蔵村山市,20～24,3729,1831,1898,3527,1722,1805,202,109,93
13223,武蔵村山市,25～29,3241,1636,1605,2981,1497,1484,260,139,121
13223,武蔵村山市,30～34,3237,1653,1584,3034,1556,1478,203,97,106
13223,武蔵村山市,35～39,3954,2087,1867,3734,1986,1748,220,101,119
13223,武蔵村山市,40～44,4376,2269,2107,4183,2199,1984,193,70,123
13223,武蔵村山市,45～49,5544,2848,2696,5391,2804,2587,153,44,109
13223,武蔵村山市,50～54,6286,3338,2948,6148,3307,2841,138,31,107
13223,武蔵村山市,55～59,5109,2694,2415,4976,2658,2318,133,36,97
13223,武蔵村山市,60～64,3810,2004,1806,3721,1973,1748,89,31,58
13223,武蔵村山市,65～69,3535,1772,1763,3485,1754,1731,50,18,32
13223,武蔵村山市,70～74,4597,2186,2411,4560,2172,2388,37,14,23
13223,武蔵村山市,75～79,4276,1926,2350,4258,1920,2338,18,6,12
13223,武蔵村山市,80～84,3633,1488,2145,3619,1479,2140,14,9,5
13223,武蔵村山市,85～89,2080,824,1256,2069,821,1248,11,3,8
13223,武蔵村山市,90～94,802,255,547,799,254,545,3,1,2
13223,武蔵村山市,95～99,172,35,137,171,35,136,1,-,1
13223,武蔵村山市,100以上,31,2,29,31,2,29,-,-,-
13224,多摩市,総数,147776,72350,75426,144410,70707,73703,3366,1643,1723
13224,多摩市,0～4,4123,2129,1994,4027,2080,1947,96,49,47
13224,多摩市,5～9,5385,2737,2648,5310,2702,2608,75,35,40
13224,多摩市,10～14,6032,3091,2941,5968,3057,2911,64,34,30
13224,多摩市,15～19,6520,3340,3180,6421,3293,3128,99,47,52
13224,多摩市,20～24,7573,3854,3719,7052,3570,3482,521,284,237
13224,多摩市,25～29,6966,3589,3377,6458,3297,3161,508,292,216
13224,多摩市,30～34,6910,3657,3253,6468,3401,3067,442,256,186
13224,多摩市,35～39,8315,4264,4051,8019,4116,3903,296,148,148
13224,多摩市,40～44,9662,4967,4695,9380,4838,4542,282,129,153
13224,多摩市,45～49,11536,5892,5644,11326,5806,5520,210,86,124
13224,多摩市,50～54,12366,6293,6073,12151,6220,5931,215,73,142
13224,多摩市,55～59,10529,5387,5142,10331,5315,5016,198,72,126
13224,多摩市,60～64,8439,4217,4222,8294,4161,4133,145,56,89
13224,多摩市,65～69,7999,3681,4318,7915,3660,4255,84,21,63
13224,多摩市,70～74,10342,4640,5702,10288,4616,5672,54,24,30
13224,多摩市,75～79,10120,4545,5575,10084,4525,5559,36,20,16
13224,多摩市,80～84,8080,3525,4555,8057,3516,4541,23,9,14
13224,多摩市,85～89,4377,1777,2600,4365,1771,2594,12,6,6
13224,多摩市,90～94,1935,660,1275,1930,658,1272,5,2,3
13224,多摩市,95～99,501,100,401,500,100,400,1,-,1
13224,多摩市,100以上,66,5,61,66,5,61,-,-,-
13225,稲城市,総数,93781,46910,46871,91932,45940,45992,1849,970,879
13225,稲城市,0～4,3699,1845,1854,3631,1816,1815,68,29,39
13225,稲城市,5～9,4614,2395,2219,4539,2362,2177,75,33,42
13225,稲城市,10～14,4627,2389,2238,4572,2359,2213,55,30,25
13225,稲城市,15～19,4814,2419,2395,4771,2396,2375,43,23,20
13225,稲城市,20～24,5146,2599,2547,4981,2490,2491,165,109,56
13225,稲城市,25～29,4790,2472,2318,4519,2301,2218,271,171,100
13225,稲城市,30～34,4895,2488,2407,4668,2354,2314,227,134,93
13225,稲城市,35～39,5815,2968,2847,5620,2873,2747,195,95,100
13225,稲城市,40～44,6424,3199,3225,6221,3100,3121,203,99,104
13225,稲城市,45～49,7484,3894,3590,7348,3826,3522,136,68,68
13225,稲城市,50～54,8390,4303,4087,8285,4268,4017,105,35,70
13225,稲城市,55～59,7169,3858,3311,7052,3806,3246,117,52,65
13225,稲城市,60～64,5274,2770,2504,5198,2732,2466,76,38,38
13225,稲城市,65～69,4243,2120,2123,4205,2104,2101,38,16,22
13225,稲城市,70～74,4830,2283,2547,4795,2263,2532,35,20,15
13225,稲城市,75～79,4639,2096,2543,4619,2087,2532,20,9,11
13225,稲城市,80～84,3664,1602,2062,3653,1598,2055,11,4,7
13225,稲城市,85～89,2140,872,1268,2132,868,1264,8,4,4
13225,稲城市,90～94,872,302,570,871,301,570,1,1,-
13225,稲城市,95～99,215,32,183,215,32,183,-,-,-
13225,稲城市,100以上,37,4,33,37,4,33,-,-,-
13227,羽村市,総数,54416,27558,26858,52600,26665,25935,1816,893,923
13227,羽村市,0～4,1616,826,790,1556,799,757,60,27,33
13227,羽村市,5～9,2031,1085,946,1989,1064,925,42,21,21
13227,羽村市,10～14,2423,1261,1162,2370,1233,1137,53,28,25
13227,羽村市,15～19,2670,1365,1305,2574,1308,1266,96,57,39
13227,羽村市,20～24,2993,1586,1407,2718,1418,1300,275,168,107
13227,羽村市,25～29,2762,1551,1211,2522,1403,1119,240,148,92
13227,羽村市,30～34,2768,1557,1211,2564,1442,1122,204,115,89
13227,羽村市,35～39,2913,1552,1361,2790,1498,1292,123,54,69
13227,羽村市,40～44,3379,1863,1516,3244,1807,1437,135,56,79
13227,羽村市,45～49,4083,2158,1925,3972,2119,1853,111,39,72
13227,羽村市,50～54,4778,2426,2352,4660,2393,2267,118,33,85
13227,羽村市,55～59,4004,2040,1964,3882,1989,1893,122,51,71
13227,羽村市,60～64,3313,1728,1585,3200,1685,1515,113,43,70
13227,羽村市,65～69,2875,1430,1445,2827,1409,1418,48,21,27
13227,羽村市,70～74,3467,1666,1801,3426,1647,1779,41,19,22
13227,羽村市,75～79,3195,1427,1768,3184,1422,1762,11,5,6
13227,羽村市,80～84,2680,1151,1529,2668,1148,1520,12,3,9
13227,羽村市,85～89,1598,636,962,1589,633,956,9,3,6
13227,羽村市,90～94,642,214,428,639,212,427,3,2,1
13227,羽村市,95～99,185,31,154,185,31,154,-,-,-
13227,羽村市,100以上,41,5,36,41,5,36,-,-,-
13228,あきる野市,総数,79513,39584,39929,78166,38849,39317,1347,735,612
13228,あきる野市,0～4,2302,1206,1096,2276,1191,1085,26,15,11
13228,あきる野市,5～9,3094,1526,1568,3060,1510,1550,34,16,18
13228,あきる野市,10～14,3548,1839,1709,3528,1828,1700,20,11,9
13228,あきる野市,15～19,3940,2018,1922,3896,1988,1908,44,30,14
13228,あきる野市,20～24,3924,2051,1873,3716,1914,1802,208,137,71
13228,あきる野市,25～29,3458,1780,1678,3215,1624,1591,243,156,87
13228,あきる野市,30～34,3395,1756,1639,3243,1657,1586,152,99,53
13228,あきる野市,35～39,3931,2067,1864,3809,1991,1818,122,76,46
13228,あきる野市,40～44,4742,2467,2275,4651,2425,2226,91,42,49
13228,あきる野市,45～49,5919,3116,2803,5836,3078,2758,83,38,45
13228,あきる野市,50～54,6754,3543,3211,6668,3520,3148,86,23,63
13228,あきる野市,55～59,5571,2889,2682,5492,2866,2626,79,23,56
13228,あきる野市,60～64,4617,2349,2268,4550,2325,2225,67,24,43
13228,あきる野市,65～69,4552,2225,2327,4515,2207,2308,37,18,19
13228,あきる野市,70～74,5462,2611,2851,5436,2598,2838,26,13,13
13228,あきる野市,75～79,5303,2492,2811,5285,2482,2803,18,10,8
13228,あきる野市,80～84,4632,2095,2537,4627,2093,2534,5,2,3
13228,あきる野市,85～89,2709,1103,1606,2704,1101,1603,5,2,3
13228,あきる野市,90～94,1226,365,861,1225,365,860,1,-,1
13228,あきる野市,95～99,364,82,282,364,82,282,-,-,-
13228,あきる野市,100以上,70,4,66,70,4,66,-,-,-
13229,西東京市,総数,205899,99968,105931,200352,97070,103282,5547,2898,2649
13229,西東京市,0～4,7051,3594,3457,6872,3509,3363,179,85,94
13229,西東京市,5～9,8661,4416,4245,8471,4305,4166,190,111,79
13229,西東京市,10～14,8781,4499,4282,8637,4425,4212,144,74,70
13229,西東京市,15～19,9104,4662,4442,8865,4508,4357,239,154,85
13229,西東京市,20～24,11167,5664,5503,10524,5252,5272,643,412,231
13229,西東京市,25～29,11345,5638,5707,10534,5146,5388,811,492,319
13229,西東京市,30～34,11262,5573,5689,10546,5190,5356,716,383,333
13229,西東京市,35～39,12569,6325,6244,11963,6006,5957,606,319,287
13229,西東京市,40～44,14001,7103,6898,13513,6861,6652,488,242,246
13229,西東京市,45～49,15760,7939,7821,15389,7758,7631,371,181,190
13229,西東京市,50～54,17208,8578,8630,16867,8439,8428,341,139,202
13229,西東京市,55～59,15835,8052,7783,15533,7945,7588,302,107,195
13229,西東京市,60～64,13056,6470,6586,12843,6393,6450,213,77,136
13229,西東京市,65～69,10524,5265,5259,10385,5211,5174,139,54,85
13229,西東京市,70～74,11239,5251,5988,11183,5225,5958,56,26,30
13229,西東京市,75～79,10002,4403,5599,9942,4378,5564,60,25,35
13229,西東京市,80～84,8262,3206,5056,8235,3194,5041,27,12,15
13229,西東京市,85～89,5995,2160,3835,5980,2156,3824,15,4,11
13229,西東京市,90～94,3079,948,2131,3072,947,2125,7,1,6
13229,西東京市,95～99,886,203,683,886,203,683,-,-,-
13229,西東京市,100以上,112,19,93,112,19,93,-,-,-
13550,町村部,総数,78744,39941,38803,77169,39124,38045,1575,817,758
13550,町村部,0～4,2143,1086,1057,2121,1074,1047,22,12,10
13550,町村部,5～9,2960,1551,1409,2930,1534,1396,30,17,13
13550,町村部,10～14,3343,1701,1642,3316,1686,1630,27,15,12
13550,町村部,15～19,3408,1863,1545,3352,1833,1519,56,30,26
13550,町村部,20～24,3060,1670,1390,2859,1553,1306,201,117,84
13550,町村部,25～29,2987,1651,1336,2728,1458,1270,259,193,66
13550,町村部,30～34,3328,1825,1503,3148,1706,1442,180,119,61
13550,町村部,35～39,4014,2114,1900,3874,2038,1836,140,76,64
13550,町村部,40～44,4729,2505,2224,4619,2461,2158,110,44,66
13550,町村部,45～49,5391,2941,2450,5289,2895,2394,102,46,56
13550,町村部,50～54,5988,3199,2789,5851,3165,2686,137,34,103
13550,町村部,55～59,5114,2812,2302,4988,2760,2228,126,52,74
13550,町村部,60～64,4701,2499,2202,4622,2474,2148,79,25,54
13550,町村部,65～69,5132,2626,2506,5076,2605,2471,56,21,35
13550,町村部,70～74,6625,3294,3331,6601,3285,3316,24,9,15
13550,町村部,75～79,6082,2938,3144,6069,2932,3137,13,6,7
13550,町村部,80～84,4649,2076,2573,4644,2076,2568,5,-,5
13550,町村部,85～89,2893,1045,1848,2888,1044,1844,5,1,4
13550,町村部,90～94,1605,444,1161,1602,444,1158,3,-,3
13550,町村部,95～99,506,94,412,506,94,412,-,-,-
13550,町村部,100以上,86,7,79,86,7,79,-,-,-
13300,郡部,総数,54951,27588,27363,53711,26935,26776,1240,653,587
13300,郡部,0～4,1367,705,662,1346,694,652,21,11,10
13300,郡部,5～9,2028,1058,970,1999,1041,958,29,17,12
13300,郡部,10～14,2404,1217,1187,2380,1204,1176,24,13,11
13300,郡部,15～19,2454,1297,1157,2406,1272,1134,48,25,23
13300,郡部,20～24,2508,1353,1155,2332,1254,1078,176,99,77
13300,郡部,25～29,2151,1175,976,1936,1015,921,215,160,55
13300,郡部,30～34,2197,1169,1028,2048,1071,977,149,98,51
13300,郡部,35～39,2653,1400,1253,2543,1341,1202,110,59,51
13300,郡部,40～44,3268,1737,1531,3186,1708,1478,82,29,53
13300,郡部,45～49,3869,2105,1764,3796,2076,1720,73,29,44
13300,郡部,50～54,4255,2211,2044,4155,2185,1970,100,26,74
13300,郡部,55～59,3628,1983,1645,3541,1947,1594,87,36,51
13300,郡部,60～64,3149,1637,1512,3088,1617,1471,61,20,41
13300,郡部,65～69,3369,1693,1676,3336,1675,1661,33,18,15
13300,郡部,70～74,4518,2194,2324,4505,2187,2318,13,7,6
13300,郡部,75～79,4297,2067,2230,4287,2062,2225,10,5,5
13300,郡部,80～84,3366,1509,1857,3363,1509,1854,3,-,3
13300,郡部,85～89,1989,725,1264,1986,724,1262,3,1,2
13300,郡部,90～94,1092,287,805,1089,287,802,3,-,3
13300,郡部,95～99,326,62,264,326,62,264,-,-,-
13300,郡部,100以上,63,4,59,63,4,59,-,-,-
13303,瑞穂町,総数,32062,16278,15784,31063,15726,15337,999,552,447
13303,瑞穂町,0～4,826,427,399,808,417,391,18,10,8
13303,瑞穂町,5～9,1157,587,570,1133,573,560,24,14,10
13303,瑞穂町,10～14,1310,652,658,1290,642,648,20,10,10
13303,瑞穂町,15～19,1481,764,717,1442,743,699,39,21,18
13303,瑞穂町,20～24,1639,882,757,1513,806,707,126,76,50
13303,瑞穂町,25～29,1474,810,664,1292,672,620,182,138,44
13303,瑞穂町,30～34,1478,817,661,1354,732,622,124,85,39
13303,瑞穂町,35～39,1663,885,778,1577,833,744,86,52,34
13303,瑞穂町,40～44,1988,1100,888,1930,1077,853,58,23,35
13303,瑞穂町,45～49,2333,1281,1052,2274,1258,1016,59,23,36
13303,瑞穂町,50～54,2802,1413,1389,2724,1389,1335,78,24,54
13303,瑞穂町,55～59,2341,1280,1061,2265,1248,1017,76,32,44
13303,瑞穂町,60～64,1958,1000,958,1903,982,921,55,18,37
13303,瑞穂町,65～69,1895,924,971,1866,908,958,29,16,13
13303,瑞穂町,70～74,2466,1217,1249,2455,1211,1244,11,6,5
13303,瑞穂町,75～79,2150,1013,1137,2143,1010,1133,7,3,4
13303,瑞穂町,80～84,1650,745,905,1648,745,903,2,-,2
13303,瑞穂町,85～89,907,334,573,904,333,571,3,1,2
13303,瑞穂町,90～94,424,128,296,422,128,294,2,-,2
13303,瑞穂町,95～99,102,18,84,102,18,84,-,-,-
13303,瑞穂町,100以上,18,1,17,18,1,17,-,-,-
13305,日の出町,総数,16300,8036,8264,16140,7961,8179,160,75,85
13305,日の出町,0～4,422,221,201,420,221,199,2,-,2
13305,日の出町,5～9,701,377,324,698,376,322,3,1,2
13305,日の出町,10～14,913,471,442,910,469,441,3,2,1
13305,日の出町,15～19,826,443,383,819,439,380,7,4,3
13305,日の出町,20～24,683,387,296,654,367,287,29,20,9
13305,日の出町,25～29,547,290,257,521,272,249,26,18,8
13305,日の出町,30～34,548,262,286,530,250,280,18,12,6
13305,日の出町,35～39,758,386,372,747,382,365,11,4,7
13305,日の出町,40～44,991,487,504,975,485,490,16,2,14
13305,日の出町,45～49,1214,636,578,1203,631,572,11,5,6
13305,日の出町,50～54,1102,622,480,1085,620,465,17,2,15
13305,日の出町,55～59,877,460,417,871,459,412,6,1,5
13305,日の出町,60～64,769,387,382,763,385,378,6,2,4
13305,日の出町,65～69,880,436,444,878,435,443,2,1,1
13305,日の出町,70～74,1333,608,725,1333,608,725,-,-,-
13305,日の出町,75～79,1472,693,779,1470,692,778,2,1,1
13305,日の出町,80～84,1120,517,603,1119,517,602,1,-,1
13305,日の出町,85～89,615,229,386,615,229,386,-,-,-
13305,日の出町,90～94,388,96,292,388,96,292,-,-,-
13305,日の出町,95～99,117,28,89,117,28,89,-,-,-
13305,日の出町,100以上,24,-,24,24,-,24,-,-,-
13307,檜原村,総数,1986,987,999,1975,983,992,11,4,7
13307,檜原村,0～4,36,18,18,36,18,18,-,-,-
13307,檜原村,5～9,53,25,28,53,25,28,-,-,-
13307,檜原村,10～14,54,29,25,54,29,25,-,-,-
13307,檜原村,15～19,36,24,12,36,24,12,-,-,-
13307,檜原村,20～24,44,16,28,44,16,28,-,-,-
13307,檜原村,25～29,39,27,12,39,27,12,-,-,-
13307,檜原村,30～34,45,23,22,43,23,20,2,-,2
13307,檜原村,35～39,59,38,21,57,37,20,2,1,1
13307,檜原村,40～44,94,44,50,93,43,50,1,1,-
13307,檜原村,45～49,104,58,46,104,58,46,-,-,-
13307,檜原村,50～54,95,49,46,94,49,45,1,-,1
13307,檜原村,55～59,133,76,57,131,75,56,2,1,1
13307,檜原村,60～64,140,79,61,140,79,61,-,-,-
13307,檜原村,65～69,183,102,81,183,102,81,-,-,-
13307,檜原村,70～74,214,117,97,212,116,96,2,1,1
13307,檜原村,75～79,183,101,82,183,101,82,-,-,-
13307,檜原村,80～84,174,75,99,174,75,99,-,-,-
13307,檜原村,85～89,167,57,110,167,57,110,-,-,-
13307,檜原村,90～94,86,23,63,85,23,62,1,-,1
13307,檜原村,95～99,40,6,34,40,6,34,-,-,-
13307,檜原村,100以上,7,-,7,7,-,7,-,-,-
13308,奥多摩町,総数,4603,2287,2316,4533,2265,2268,70,22,48
13308,奥多摩町,0～4,83,39,44,82,38,44,1,1,-
13308,奥多摩町,5～9,117,69,48,115,67,48,2,2,-
13308,奥多摩町,10～14,127,65,62,126,64,62,1,1,-
13308,奥多摩町,15～19,111,66,45,109,66,43,2,-,2
13308,奥多摩町,20～24,142,68,74,121,65,56,21,3,18
13308,奥多摩町,25～29,91,48,43,84,44,40,7,4,3
13308,奥多摩町,30～34,126,67,59,121,66,55,5,1,4
13308,奥多摩町,35～39,173,91,82,162,89,73,11,2,9
13308,奥多摩町,40～44,195,106,89,188,103,85,7,3,4
13308,奥多摩町,45～49,218,130,88,215,129,86,3,1,2
13308,奥多摩町,50～54,256,127,129,252,127,125,4,-,4
13308,奥多摩町,55～59,277,167,110,274,165,109,3,2,1
13308,奥多摩町,60～64,282,171,111,282,171,111,-,-,-
13308,奥多摩町,65～69,411,231,180,409,230,179,2,1,1
13308,奥多摩町,70～74,505,252,253,505,252,253,-,-,-
13308,奥多摩町,75～79,492,260,232,491,259,232,1,1,-
13308,奥多摩町,80～84,422,172,250,422,172,250,-,-,-
13308,奥多摩町,85～89,300,105,195,300,105,195,-,-,-
13308,奥多摩町,90～94,194,40,154,194,40,154,-,-,-
13308,奥多摩町,95～99,67,10,57,67,10,57,-,-,-
13308,奥多摩町,100以上,14,3,11,14,3,11,-,-,-
13350,島部,総数,23793,12353,11440,23458,12189,11269,335,164,171
13350,島部,0～4,776,381,395,775,380,395,1,1,-
13350,島部,5～9,932,493,439,931,493,438,1,-,1
13350,島部,10～14,939,484,455,936,482,454,3,2,1
13350,島部,15～19,954,566,388,946,561,385,8,5,3
13350,島部,20～24,552,317,235,527,299,228,25,18,7
13350,島部,25～29,836,476,360,792,443,349,44,33,11
13350,島部,30～34,1131,656,475,1100,635,465,31,21,10
13350,島部,35～39,1361,714,647,1331,697,634,30,17,13
13350,島部,40～44,1461,768,693,1433,753,680,28,15,13
13350,島部,45～49,1522,836,686,1493,819,674,29,17,12
13350,島部,50～54,1733,988,745,1696,980,716,37,8,29
13350,島部,55～59,1486,829,657,1447,813,634,39,16,23
13350,島部,60～64,1552,862,690,1534,857,677,18,5,13
13350,島部,65～69,1763,933,830,1740,930,810,23,3,20
13350,島部,70～74,2107,1100,1007,2096,1098,998,11,2,9
13350,島部,75～79,1785,871,914,1782,870,912,3,1,2
13350,島部,80～84,1283,567,716,1281,567,714,2,-,2
13350,島部,85～89,904,320,584,902,320,582,2,-,2
13350,島部,90～94,513,157,356,513,157,356,-,-,-
13350,島部,95～99,180,32,148,180,32,148,-,-,-
13350,島部,100以上,23,3,20,23,3,20,-,-,-
13360,大島支庁,総数,11524,5911,5613,11372,5798,5574,152,113,39
13360,大島支庁,0～4,331,157,174,331,157,174,-,-,-
13360,大島支庁,5～9,406,212,194,405,212,193,1,-,1
13360,大島支庁,10～14,462,244,218,460,243,217,2,1,1
13360,大島支庁,15～19,563,349,214,559,345,214,4,4,-
13360,大島支庁,20～24,301,170,131,286,158,128,15,12,3
13360,大島支庁,25～29,366,201,165,337,182,155,29,19,10
13360,大島支庁,30～34,485,293,192,465,277,188,20,16,4
13360,大島支庁,35～39,594,310,284,580,299,281,14,11,3
13360,大島支庁,40～44,666,360,306,655,350,305,11,10,1
13360,大島支庁,45～49,708,389,319,694,376,318,14,13,1
13360,大島支庁,50～54,781,446,335,769,439,330,12,7,5
13360,大島支庁,55～59,717,378,339,700,365,335,17,13,4
13360,大島支庁,60～64,768,416,352,763,412,351,5,4,1
13360,大島支庁,65～69,902,467,435,896,465,431,6,2,4
13360,大島支庁,70～74,1049,537,512,1048,536,512,1,1,-
13360,大島支庁,75～79,899,427,472,899,427,472,-,-,-
13360,大島支庁,80～84,695,291,404,695,291,404,-,-,-
13360,大島支庁,85～89,452,156,296,451,156,295,1,-,1
13360,大島支庁,90～94,279,86,193,279,86,193,-,-,-
13360,大島支庁,95～99,88,20,68,88,20,68,-,-,-
13360,大島支庁,100以上,12,2,10,12,2,10,-,-,-
13361,大島町,総数,6982,3635,3347,6858,3535,3323,124,100,24
13361,大島町,0～4,200,90,110,200,90,110,-,-,-
13361,大島町,5～9,228,122,106,227,122,105,1,-,1
13361,大島町,10～14,254,142,112,252,141,111,2,1,1
13361,大島町,15～19,383,255,128,379,251,128,4,4,-
13361,大島町,20～24,156,90,66,146,80,66,10,10,-
13361,大島町,25～29,214,120,94,198,109,89,16,11,5
13361,大島町,30～34,307,185,122,289,171,118,18,14,4
13361,大島町,35～39,333,183,150,320,172,148,13,11,2
13361,大島町,40～44,377,205,172,366,195,171,11,10,1
13361,大島町,45～49,404,218,186,390,205,185,14,13,1
13361,大島町,50～54,500,287,213,491,281,210,9,6,3
13361,大島町,55～59,474,256,218,458,243,215,16,13,3
13361,大島町,60～64,456,255,201,451,251,200,5,4,1
13361,大島町,65～69,513,273,240,509,271,238,4,2,2
13361,大島町,70～74,648,326,322,647,325,322,1,1,-
13361,大島町,75～79,559,267,292,559,267,292,-,-,-
13361,大島町,80～84,475,199,276,475,199,276,-,-,-
13361,大島町,85～89,285,105,180,285,105,180,-,-,-
13361,大島町,90～94,158,45,113,158,45,113,-,-,-
13361,大島町,95～99,50,11,39,50,11,39,-,-,-
13361,大島町,100以上,8,1,7,8,1,7,-,-,-
13362,利島村,総数,314,170,144,307,166,141,7,4,3
13362,利島村,0～4,9,6,3,9,6,3,-,-,-
13362,利島村,5～9,14,4,10,14,4,10,-,-,-
13362,利島村,10～14,18,10,8,18,10,8,-,-,-
13362,利島村,15～19,12,5,7,12,5,7,-,-,-
13362,利島村,20～24,10,8,2,10,8,2,-,-,-
13362,利島村,25～29,21,8,13,18,6,12,3,2,1
13362,利島村,30～34,24,13,11,22,11,11,2,2,-
13362,利島村,35～39,29,16,13,29,16,13,-,-,-
13362,利島村,40～44,26,16,10,26,16,10,-,-,-
13362,利島村,45～49,33,20,13,33,20,13,-,-,-
13362,利島村,50～54,10,8,2,10,8,2,-,-,-
13362,利島村,55～59,18,9,9,17,9,8,1,-,1
13362,利島村,60～64,19,11,8,19,11,8,-,-,-
13362,利島村,65～69,16,9,7,15,9,6,1,-,1
13362,利島村,70～74,22,11,11,22,11,11,-,-,-
13362,利島村,75～79,16,9,7,16,9,7,-,-,-
13362,利島村,80～84,6,2,4,6,2,4,-,-,-
13362,利島村,85～89,6,2,4,6,2,4,-,-,-
13362,利島村,90～94,4,3,1,4,3,1,-,-,-
13362,利島村,95～99,1,-,1,1,-,1,-,-,-
13362,利島村,100以上,-,-,-,-,-,-,-,-,-
13363,新島村,総数,2453,1195,1258,2440,1193,1247,13,2,11
13363,新島村,0～4,64,33,31,64,33,31,-,-,-
13363,新島村,5～9,76,39,37,76,39,37,-,-,-
13363,新島村,10～14,92,41,51,92,41,51,-,-,-
13363,新島村,15～19,81,46,35,81,46,35,-,-,-
13363,新島村,20～24,82,39,43,79,39,40,3,-,3
13363,新島村,25～29,67,34,33,62,33,29,5,1,4
13363,新島村,30～34,85,49,36,85,49,36,-,-,-
13363,新島村,35～39,121,53,68,120,53,67,1,-,1
13363,新島村,40～44,147,82,65,147,82,65,-,-,-
13363,新島村,45～49,162,92,70,162,92,70,-,-,-
13363,新島村,50～54,164,92,72,162,91,71,2,1,1
13363,新島村,55～59,143,77,66,143,77,66,-,-,-
13363,新島村,60～64,162,77,85,162,77,85,-,-,-
13363,新島村,65～69,202,97,105,201,97,104,1,-,1
13363,新島村,70～74,226,110,116,226,110,116,-,-,-
13363,新島村,75～79,214,101,113,214,101,113,-,-,-
13363,新島村,80～84,141,63,78,141,63,78,-,-,-
13363,新島村,85～89,110,35,75,109,35,74,1,-,1
13363,新島村,90～94,82,26,56,82,26,56,-,-,-
13363,新島村,95～99,28,8,20,28,8,20,-,-,-
13363,新島村,100以上,4,1,3,4,1,3,-,-,-
13364,神津島村,総数,1775,911,864,1767,904,863,8,7,1
13364,神津島村,0～4,58,28,30,58,28,30,-,-,-
13364,神津島村,5～9,88,47,41,88,47,41,-,-,-
13364,神津島村,10～14,98,51,47,98,51,47,-,-,-
13364,神津島村,15～19,87,43,44,87,43,44,-,-,-
13364,神津島村,20～24,53,33,20,51,31,20,2,2,-
13364,神津島村,25～29,64,39,25,59,34,25,5,5,-
13364,神津島村,30～34,69,46,23,69,46,23,-,-,-
13364,神津島村,35～39,111,58,53,111,58,53,-,-,-
13364,神津島村,40～44,116,57,59,116,57,59,-,-,-
13364,神津島村,45～49,109,59,50,109,59,50,-,-,-
13364,神津島村,50～54,107,59,48,106,59,47,1,-,1
13364,神津島村,55～59,82,36,46,82,36,46,-,-,-
13364,神津島村,60～64,131,73,58,131,73,58,-,-,-
13364,神津島村,65～69,171,88,83,171,88,83,-,-,-
13364,神津島村,70～74,153,90,63,153,90,63,-,-,-
13364,神津島村,75～79,110,50,60,110,50,60,-,-,-
13364,神津島村,80～84,73,27,46,73,27,46,-,-,-
13364,神津島村,85～89,51,14,37,51,14,37,-,-,-
13364,神津島村,90～94,35,12,23,35,12,23,-,-,-
13364,神津島村,95～99,9,1,8,9,1,8,-,-,-
13364,神津島村,100以上,-,-,-,-,-,-,-,-,-
13380,三宅支庁,総数,2545,1404,1141,2514,1396,1118,31,8,23
13380,三宅支庁,0～4,89,44,45,89,44,45,-,-,-
13380,三宅支庁,5～9,115,62,53,115,62,53,-,-,-
13380,三宅支庁,10～14,83,42,41,83,42,41,-,-,-
13380,三宅支庁,15～19,45,30,15,45,30,15,-,-,-
13380,三宅支庁,20～24,54,33,21,53,32,21,1,1,-
13380,三宅支庁,25～29,101,60,41,99,58,41,2,2,-
13380,三宅支庁,30～34,146,86,60,144,84,60,2,2,-
13380,三宅支庁,35～39,170,91,79,166,90,76,4,1,3
13380,三宅支庁,40～44,163,84,79,162,84,78,1,-,1
13380,三宅支庁,45～49,152,90,62,152,90,62,-,-,-
13380,三宅支庁,50～54,153,107,46,147,106,41,6,1,5
13380,三宅支庁,55～59,139,85,54,131,85,46,8,-,8
13380,三宅支庁,60～64,191,111,80,187,110,77,4,1,3
13380,三宅支庁,65～69,202,119,83,201,119,82,1,-,1
13380,三宅支庁,70～74,212,118,94,211,118,93,1,-,1
13380,三宅支庁,75～79,196,112,84,196,112,84,-,-,-
13380,三宅支庁,80～84,127,64,63,126,64,62,1,-,1
13380,三宅支庁,85～89,129,45,84,129,45,84,-,-,-
13380,三宅支庁,90～94,59,17,42,59,17,42,-,-,-
13380,三宅支庁,95～99,19,4,15,19,4,15,-,-,-
13380,三宅支庁,100以上,-,-,-,-,-,-,-,-,-
13381,三宅村,総数,2254,1247,1007,2224,1239,985,30,8,22
13381,三宅村,0～4,78,37,41,78,37,41,-,-,-
13381,三宅村,5～9,93,52,41,93,52,41,-,-,-
13381,三宅村,10～14,65,31,34,65,31,34,-,-,-
13381,三宅村,15～19,41,28,13,41,28,13,-,-,-
13381,三宅村,20～24,49,30,19,48,29,19,1,1,-
13381,三宅村,25～29,83,52,31,81,50,31,2,2,-
13381,三宅村,30～34,129,77,52,127,75,52,2,2,-
13381,三宅村,35～39,141,76,65,137,75,62,4,1,3
13381,三宅村,40～44,131,71,60,130,71,59,1,-,1
13381,三宅村,45～49,123,70,53,123,70,53,-,-,-
13381,三宅村,50～54,135,97,38,130,96,34,5,1,4
13381,三宅村,55～59,125,78,47,117,78,39,8,-,8
13381,三宅村,60～64,178,102,76,174,101,73,4,1,3
13381,三宅村,65～69,183,108,75,182,108,74,1,-,1
13381,三宅村,70～74,196,113,83,195,113,82,1,-,1
13381,三宅村,75～79,180,100,80,180,100,80,-,-,-
13381,三宅村,80～84,120,59,61,119,59,60,1,-,1
13381,三宅村,85～89,129,45,84,129,45,84,-,-,-
13381,三宅村,90～94,56,17,39,56,17,39,-,-,-
13381,三宅村,95～99,19,4,15,19,4,15,-,-,-
13381,三宅村,100以上,-,-,-,-,-,-,-,-,-
13382,御蔵島村,総数,291,157,134,290,157,133,1,-,1
13382,御蔵島村,0～4,11,7,4,11,7,4,-,-,-
13382,御蔵島村,5～9,22,10,12,22,10,12,-,-,-
13382,御蔵島村,10～14,18,11,7,18,11,7,-,-,-
13382,御蔵島村,15～19,4,2,2,4,2,2,-,-,-
13382,御蔵島村,20～24,5,3,2,5,3,2,-,-,-
13382,御蔵島村,25～29,18,8,10,18,8,10,-,-,-
13382,御蔵島村,30～34,17,9,8,17,9,8,-,-,-
13382,御蔵島村,35～39,29,15,14,29,15,14,-,-,-
13382,御蔵島村,40～44,32,13,19,32,13,19,-,-,-
13382,御蔵島村,45～49,29,20,9,29,20,9,-,-,-
13382,御蔵島村,50～54,18,10,8,17,10,7,1,-,1
13382,御蔵島村,55～59,14,7,7,14,7,7,-,-,-
13382,御蔵島村,60～64,13,9,4,13,9,4,-,-,-
13382,御蔵島村,65～69,19,11,8,19,11,8,-,-,-
13382,御蔵島村,70～74,16,5,11,16,5,11,-,-,-
13382,御蔵島村,75～79,16,12,4,16,12,4,-,-,-
13382,御蔵島村,80～84,7,5,2,7,5,2,-,-,-
13382,御蔵島村,85～89,-,-,-,-,-,-,-,-,-
13382,御蔵島村,90～94,3,-,3,3,-,3,-,-,-
13382,御蔵島村,95～99,-,-,-,-,-,-,-,-,-
13382,御蔵島村,100以上,-,-,-,-,-,-,-,-,-
13400,八丈支庁,総数,7124,3584,3540,7004,3562,3442,120,22,98
13400,八丈支庁,0～4,227,115,112,226,114,112,1,1,-
13400,八丈支庁,5～9,283,152,131,283,152,131,-,-,-
13400,八丈支庁,10～14,253,125,128,252,124,128,1,1,-
13400,八丈支庁,15～19,240,126,114,237,126,111,3,-,3
13400,八丈支庁,20～24,129,72,57,124,71,53,5,1,4
13400,八丈支庁,25～29,223,128,95,214,120,94,9,8,1
13400,八丈支庁,30～34,310,162,148,305,161,144,5,1,4
13400,八丈支庁,35～39,396,212,184,388,210,178,8,2,6
13400,八丈支庁,40～44,407,202,205,394,198,196,13,4,9
13400,八丈支庁,45～49,424,233,191,414,232,182,10,1,9
13400,八丈支庁,50～54,526,279,247,507,279,228,19,-,19
13400,八丈支庁,55～59,445,262,183,432,260,172,13,2,11
13400,八丈支庁,60～64,469,256,213,460,256,204,9,-,9
13400,八丈支庁,65～69,537,275,262,522,274,248,15,1,14
13400,八丈支庁,70～74,726,368,358,720,368,352,6,-,6
13400,八丈支庁,75～79,589,272,317,588,272,316,1,-,1
13400,八丈支庁,80～84,407,183,224,406,183,223,1,-,1
13400,八丈支庁,85～89,297,104,193,296,104,192,1,-,1
13400,八丈支庁,90～94,162,51,111,162,51,111,-,-,-
13400,八丈支庁,95～99,66,6,60,66,6,60,-,-,-
13400,八丈支庁,100以上,8,1,7,8,1,7,-,-,-
13401,八丈町,総数,6968,3496,3472,6848,3474,3374,120,22,98
13401,八丈町,0～4,222,113,109,221,112,109,1,1,-
13401,八丈町,5～9,277,151,126,277,151,126,-,-,-
13401,八丈町,10～14,248,124,124,247,123,124,1,1,-
13401,八丈町,15～19,239,126,113,236,126,110,3,-,3
13401,八丈町,20～24,125,70,55,120,69,51,5,1,4
13401,八丈町,25～29,211,123,88,202,115,87,9,8,1
13401,八丈町,30～34,299,153,146,294,152,142,5,1,4
13401,八丈町,35～39,372,200,172,364,198,166,8,2,6
13401,八丈町,40～44,393,192,201,380,188,192,13,4,9
13401,八丈町,45～49,418,228,190,408,227,181,10,1,9
13401,八丈町,50～54,516,275,241,497,275,222,19,-,19
13401,八丈町,55～59,436,257,179,423,255,168,13,2,11
13401,八丈町,60～64,458,248,210,449,248,201,9,-,9
13401,八丈町,65～69,522,265,257,507,264,243,15,1,14
13401,八丈町,70～74,718,363,355,712,363,349,6,-,6
13401,八丈町,75～79,580,265,315,579,265,314,1,-,1
13401,八丈町,80～84,405,182,223,404,182,222,1,-,1
13401,八丈町,85～89,295,104,191,294,104,190,1,-,1
13401,八丈町,90～94,160,50,110,160,50,110,-,-,-
13401,八丈町,95～99,66,6,60,66,6,60,-,-,-
13401,八丈町,100以上,8,1,7,8,1,7,-,-,-
13402,青ヶ島村,総数,156,88,68,156,88,68,-,-,-
13402,青ヶ島村,0～4,5,2,3,5,2,3,-,-,-
13402,青ヶ島村,5～9,6,1,5,6,1,5,-,-,-
13402,青ヶ島村,10～14,5,1,4,5,1,4,-,-,-
13402,青ヶ島村,15～19,1,-,1,1,-,1,-,-,-
13402,青ヶ島村,20～24,4,2,2,4,2,2,-,-,-
13402,青ヶ島村,25～29,12,5,7,12,5,7,-,-,-
13402,青ヶ島村,30～34,11,9,2,11,9,2,-,-,-
13402,青ヶ島村,35～39,24,12,12,24,12,12,-,-,-
13402,青ヶ島村,40～44,14,10,4,14,10,4,-,-,-
13402,青ヶ島村,45～49,6,5,1,6,5,1,-,-,-
13402,青ヶ島村,50～54,10,4,6,10,4,6,-,-,-
13402,青ヶ島村,55～59,9,5,4,9,5,4,-,-,-
13402,青ヶ島村,60～64,11,8,3,11,8,3,-,-,-
13402,青ヶ島村,65～69,15,10,5,15,10,5,-,-,-
13402,青ヶ島村,70～74,8,5,3,8,5,3,-,-,-
13402,青ヶ島村,75～79,9,7,2,9,7,2,-,-,-
13402,青ヶ島村,80～84,2,1,1,2,1,1,-,-,-
13402,青ヶ島村,85～89,2,-,2,2,-,2,-,-,-
13402,青ヶ島村,90～94,2,1,1,2,1,1,-,-,-
13402,青ヶ島村,95～99,-,-,-,-,-,-,-,-,-
13402,青ヶ島村,100以上,-,-,-,-,-,-,-,-,-
13402,青ヶ島村,不詳者,-,-,-,-,-,-,-,-,-
13420,小笠原支庁,総数,2600,1454,1146,2568,1433,1135,32,21,11
13420,小笠原支庁,0～4,129,65,64,129,65,64,-,-,-
13420,小笠原支庁,5～9,128,67,61,128,67,61,-,-,-
13420,小笠原支庁,10～14,141,73,68,141,73,68,-,-,-
13420,小笠原支庁,15～19,106,61,45,105,60,45,1,1,-
13420,小笠原支庁,20～24,68,42,26,64,38,26,4,4,-
13420,小笠原支庁,25～29,146,87,59,142,83,59,4,4,-
13420,小笠原支庁,30～34,190,115,75,186,113,73,4,2,2
13420,小笠原支庁,35～39,201,101,100,197,98,99,4,3,1
13420,小笠原支庁,40～44,225,122,103,222,121,101,3,1,2
13420,小笠原支庁,45～49,238,124,114,233,121,112,5,3,2
13420,小笠原支庁,50～54,273,156,117,273,156,117,-,-,-
13420,小笠原支庁,55～59,185,104,81,184,103,81,1,1,-
13420,小笠原支庁,60～64,124,79,45,124,79,45,-,-,-
13420,小笠原支庁,65～69,122,72,50,121,72,49,1,-,1
13420,小笠原支庁,70～74,120,77,43,117,76,41,3,1,2
13420,小笠原支庁,75～79,101,60,41,99,59,40,2,1,1
13420,小笠原支庁,80～84,54,29,25,54,29,25,-,-,-
13420,小笠原支庁,85～89,26,15,11,26,15,11,-,-,-
13420,小笠原支庁,90～94,13,3,10,13,3,10,-,-,-
13420,小笠原支庁,95～99,7,2,5,7,2,5,-,-,-
13420,小笠原支庁,100以上,3,-,3,3,-,3,-,-,-
13421,小笠原村,総数,2600,1454,1146,2568,1433,1135,32,21,11
13421,小笠原村,0～4,129,65,64,129,65,64,-,-,-
13421,小笠原村,5～9,128,67,61,128,67,61,-,-,-
13421,小笠原村,10～14,141,73,68,141,73,68,-,-,-
13421,小笠原村,15～19,106,61,45,105,60,45,1,1,-
13421,小笠原村,20～24,68,42,26,64,38,26,4,4,-
13421,小笠原村,25～29,146,87,59,142,83,59,4,4,-
13421,小笠原村,30～34,190,115,75,186,113,73,4,2,2
13421,小笠原村,35～39,201,101,100,197,98,99,4,3,1
13421,小笠原村,40～44,225,122,103,222,121,101,3,1,2
13421,小笠原村,45～49,238,124,114,233,121,112,5,3,2
13421,小笠原村,50～54,273,156,117,273,156,117,-,-,-
13421,小笠原村,55～59,185,104,81,184,103,81,1,1,-
13421,小笠原村,60～64,124,79,45,124,79,45,-,-,-
13421,小笠原村,65～69,122,72,50,121,72,49,1,-,1
13421,小笠原村,70～74,120,77,43,117,76,41,3,1,2
13421,小笠原村,75～79,101,60,41,99,59,40,2,1,1
13421,小笠原村,80～84,54,29,25,54,29,25,-,-,-
13421,小笠原村,85～89,26,15,11,26,15,11,-,-,-
13421,小笠原村,90～94,13,3,10,13,3,10,-,-,-
13421,小笠原村,95～99,7,2,5,7,2,5,-,-,-
13421,小笠原村,100以上,3,-,3,3,-,3,-,-,-